Estimate!!Total:GEOGRAPHICAL MOBILITY IN THE PAST YEAR BY AGE FOR CURRENT RESIDENCE IN THE UNITED STATES,Estimate!!Total:!!Moved from different county within same state:GEOGRAPHICAL MOBILITY IN THE PAST YEAR BY AGE FOR CURRENT RESIDENCE IN THE UNITED STATES,Estimate!!Total:!!Moved from different state:GEOGRAPHICAL MOBILITY IN THE PAST YEAR BY AGE FOR CURRENT RESIDENCE IN THE UNITED STATES,Estimate!!Total:!!Moved from abroad:GEOGRAPHICAL MOBILITY IN THE PAST YEAR BY AGE FOR CURRENT RESIDENCE IN THE UNITED STATES,Estimate!!Total:!!Public transportation (excluding taxicab):MEANS OF TRANSPORTATION TO WORK BY AGE,Estimate!!Total:MEANS OF TRANSPORTATION TO WORK BY AGE,"Estimate!!Total:HOUSEHOLDS BY PRESENCE OF PEOPLE 65 YEARS AND OVER, HOUSEHOLD SIZE AND HOUSEHOLD TYPE","Estimate!!Total:!!Households with one or more people 65 years and over:HOUSEHOLDS BY PRESENCE OF PEOPLE 65 YEARS AND OVER, HOUSEHOLD SIZE AND HOUSEHOLD TYPE","Estimate!!Total:!!Households with one or more people 65 years and over:!!2-or-more-person household:HOUSEHOLDS BY PRESENCE OF PEOPLE 65 YEARS AND OVER, HOUSEHOLD SIZE AND HOUSEHOLD TYPE","Estimate!!Total:!!Households with one or more people 65 years and over:!!2-or-more-person household:!!Family householdsHOUSEHOLDS BY PRESENCE OF PEOPLE 65 YEARS AND OVER, HOUSEHOLD SIZE AND HOUSEHOLD TYPE","Estimate!!Total:!!Households with one or more people 65 years and over:!!2-or-more-person household:!!Nonfamily householdsHOUSEHOLDS BY PRESENCE OF PEOPLE 65 YEARS AND OVER, HOUSEHOLD SIZE AND HOUSEHOLD TYPE","Estimate!!Total:!!Households with no people 65 years and over:HOUSEHOLDS BY PRESENCE OF PEOPLE 65 YEARS AND OVER, HOUSEHOLD SIZE AND HOUSEHOLD TYPE","Estimate!!Total:!!Households with no people 65 years and over:!!2-or-more-person household:HOUSEHOLDS BY PRESENCE OF PEOPLE 65 YEARS AND OVER, HOUSEHOLD SIZE AND HOUSEHOLD TYPE","Estimate!!Total:!!Households with no people 65 years and over:!!2-or-more-person household:!!Family householdsHOUSEHOLDS BY PRESENCE OF PEOPLE 65 YEARS AND OVER, HOUSEHOLD SIZE AND HOUSEHOLD TYPE","Estimate!!Total:!!Households with no people 65 years and over:!!2-or-more-person household:!!Nonfamily householdsHOUSEHOLDS BY PRESENCE OF PEOPLE 65 YEARS AND OVER, HOUSEHOLD SIZE AND HOUSEHOLD TYPE",Estimate!!Total:HOUSEHOLD TYPE BY UNITS IN STRUCTURE,Estimate!!Median household income in the past 12 months (in 2019 inflation-adjusted dollars)MEDIAN HOUSEHOLD INCOME IN THE PAST 12 MONTHS (IN 2019 INFLATION-ADJUSTED DOLLARS),Estimate!!Gini IndexGINI INDEX OF INCOME INEQUALITY,Estimate!!Mean usual hours--!!Total:MEAN USUAL HOURS WORKED IN THE PAST 12 MONTHS FOR WORKERS 16 TO 64 YEARS,Estimate!!Total:UNITS IN STRUCTURE,Estimate!!Total:HEALTH INSURANCE COVERAGE STATUS AND TYPE BY CITIZENSHIP STATUS,Estimate!!Total:!!Native Born:!!With health insurance coverageHEALTH INSURANCE COVERAGE STATUS AND TYPE BY CITIZENSHIP STATUS,Estimate!!Total:!!Foreign Born:!!Naturalized:!!With health insurance coverageHEALTH INSURANCE COVERAGE STATUS AND TYPE BY CITIZENSHIP STATUS,Estimate!!Total:!!Foreign Born:!!Noncitizen:!!With health insurance coverageHEALTH INSURANCE COVERAGE STATUS AND TYPE BY CITIZENSHIP STATUS,Estimate!!Total:!!Foreign Born:!!Naturalized:!!No health insurance coverageHEALTH INSURANCE COVERAGE STATUS AND TYPE BY CITIZENSHIP STATUS,Estimate!!Total:!!Foreign Born:!!Noncitizen:!!No health insurance coverageHEALTH INSURANCE COVERAGE STATUS AND TYPE BY CITIZENSHIP STATUS,Estimate!!Total:!!Native Born:!!No health insurance coverageHEALTH INSURANCE COVERAGE STATUS AND TYPE BY CITIZENSHIP STATUS,NAME,state,county,fips
21262.0,1486.0,222.0,38.0,67,8633,7737,2764,1727,1658,69,4973,3929,3639,290,7737,46650,0.4373,39.2,9315,19948,18129,94,81,55,0,1589,"Fayette County, Illinois",17,051,17051
28708.0,2171.0,331.0,10.0,52,12211,10797,3496,1993,1910,83,7301,5473,4860,613,10797,57308,0.4201,38.3,12050,25735,24298,170,113,0,59,1095,"Logan County, Illinois",17,107,17107
23730.0,610.0,258.0,40.0,85,9631,9972,3285,1723,1684,39,6687,5253,4970,283,9972,44090,0.4692,38.4,11712,23540,22336,158,53,0,0,993,"Saline County, Illinois",17,165,17165
693869.0,17578.0,18881.0,3858.0,15805,355918,246122,67788,43770,41834,1936,178334,147100,138234,8866,246122,89427,0.4847,39.2,264078,685292,534535,61007,43446,3860,21550,20894,"Lake County, Illinois",17,097,17097
14110.0,95.0,358.0,23.0,17,5602,5822,1958,1158,1125,33,3864,2943,2781,162,5822,47481,0.4097,38.6,7099,13979,13172,54,1,0,91,661,"Massac County, Illinois",17,127,17127
12366.0,280.0,96.0,223.0,12,5870,5043,1548,810,783,27,3495,2801,2553,248,5043,52373,0.4227,38.2,5822,12358,10567,354,762,0,270,405,"Cass County, Illinois",17,017,17017
35897.0,1553.0,541.0,83.0,25,18229,14742,4182,2457,2323,134,10560,8235,7584,651,14742,53632,0.3876,37.8,16049,35928,32638,187,286,4,80,2733,"Huntington County, Indiana",18,069,18069
23876.0,1104.0,626.0,49.0,25,10964,9879,3315,2174,2053,121,6564,5150,4752,398,9879,54576,0.394,40.5,13123,23866,21011,255,337,41,390,1832,"White County, Indiana",18,181,18181
20620.0,683.0,157.0,12.0,38,9400,8174,2588,1466,1377,89,5586,4348,3977,371,8174,47658,0.4177,39.3,9253,20638,18514,181,116,0,0,1827,"Jay County, Indiana",18,075,18075
43898.0,1675.0,790.0,136.0,24,21938,17823,5500,3031,2845,186,12323,10072,9100,972,17823,60404,0.4057,39.6,19329,43731,39971,232,529,33,325,2641,"Shelby County, Indiana",18,145,18145
20562.0,1272.0,315.0,39.0,0,8416,7644,2505,1539,1441,98,5139,4110,3875,235,7644,50245,0.4296,39.3,8959,18607,16625,161,2,0,16,1803,"Sullivan County, Indiana",18,153,18153
189123.0,10595.0,7670.0,4498.0,2835,93460,70526,14967,8870,8579,291,55559,39284,30231,9053,70526,53130,0.4703,36.4,76297,189817,154926,5207,14710,158,2911,11905,"Tippecanoe County, Indiana",18,157,18157
319658.0,14809.0,9215.0,1574.0,132,170914,119789,26273,17523,16933,590,93516,77093,71407,5686,119789,98173,0.4444,39.8,126526,321620,284070,13724,9741,939,1676,11470,"Hamilton County, Indiana",18,057,18057
81581.0,2907.0,1771.0,1553.0,129,39409,31452,9081,5276,5103,173,22371,17554,15586,1968,31452,63431,0.4298,39.2,34347,81610,67565,1332,5732,164,1296,5521,"Bartholomew County, Indiana",18,005,18005
19889.0,706.0,122.0,15.0,55,8981,7799,2665,1564,1480,84,5134,3814,3520,294,7799,52034,0.4239,40.4,9703,19898,17395,186,218,57,150,1892,"Fulton County, Indiana",18,049,18049
46866.0,2476.0,651.0,137.0,25,22584,18276,5125,3101,2929,172,13151,10434,9640,794,18276,56789,0.4006,40.0,20555,46734,41064,783,876,59,583,3369,"Noble County, Indiana",18,113,18113
115133.0,2818.0,2783.0,141.0,393,57330,44200,12516,7569,7236,333,31684,23490,21531,1959,44200,55630,0.4229,39.1,50564,115007,103865,1684,1133,157,1201,6967,"Clark County, Indiana",18,019,18019
162132.0,9278.0,3760.0,393.0,63,85437,59015,14825,9733,9366,367,44190,36531,34104,2427,59015,81933,0.3918,39.4,61755,161237,144771,4466,2193,439,980,8388,"Hendricks County, Indiana",18,063,18063
65858.0,1905.0,1235.0,69.0,53,28501,26372,8714,5359,5117,242,17658,13023,11797,1226,26372,44356,0.4197,36.8,30487,65606,59073,456,453,41,114,5469,"Grant County, Indiana",18,053,18053
43462.0,1248.0,435.0,273.0,98,20463,16753,4889,3017,2813,204,11864,9549,8931,618,16753,51250,0.4209,40.4,19141,43340,38159,612,926,51,477,3115,"Jackson County, Indiana",18,071,18071
20667.0,1284.0,272.0,41.0,40,9507,8776,2873,1849,1737,112,5903,4533,4086,447,8776,49543,0.4043,39.3,10183,20684,18269,85,82,41,31,2176,"Owen County, Indiana",18,119,18119
33273.0,1456.0,245.0,50.0,9,16968,13742,4171,2631,2524,107,9571,7612,7082,530,13742,61741,0.411,39.9,14789,33351,30346,297,138,8,32,2530,"Whitley County, Indiana",18,183,18183
31760.0,932.0,444.0,8.0,12,14633,12033,3442,2101,2079,22,8591,6689,6108,581,12033,54286,0.3786,38.9,13342,31718,27111,332,1079,123,644,2429,"Clinton County, Indiana",18,023,18023
7054.0,240.0,707.0,0.0,0,3341,2823,942,513,495,18,1881,1484,1373,111,2823,50375,0.3826,40.9,3256,7057,6313,9,61,27,45,602,"Union County, Indiana",18,161,18161
49113.0,863.0,2020.0,72.0,105,24455,18870,5909,3964,3734,230,12961,10789,9976,813,18870,68658,0.4032,38.7,20498,48946,45928,340,222,0,39,2417,"Dearborn County, Indiana",18,029,18029
44928.0,987.0,322.0,129.0,8,20717,18781,6253,3895,3750,145,12528,9661,8921,740,18781,53610,0.4055,39.3,21157,44932,40617,333,211,0,115,3656,"Lawrence County, Indiana",18,093,18093
18838.0,658.0,349.0,27.0,0,8258,7615,2605,1459,1436,23,5010,3853,3529,324,7615,52348,0.3985,39.3,8704,17487,16590,90,74,0,20,713,"Perry County, Indiana",18,123,18123
25373.0,731.0,432.0,0.0,9,12215,10155,3065,2094,2011,83,7090,5563,5248,315,10155,64196,0.4124,39.0,11508,25318,23980,93,41,0,37,1167,"Posey County, Indiana",18,129,18129
19908.0,898.0,72.0,6.0,24,9259,8002,2635,1547,1473,74,5367,4237,3940,297,8002,54806,0.4112,40.3,9625,19962,17943,208,167,63,83,1498,"Carroll County, Indiana",18,015,18015
16272.0,955.0,185.0,23.0,62,7457,6974,2284,1405,1363,42,4690,3664,3331,333,6974,52874,0.4318,39.6,7899,16279,14892,65,30,35,102,1155,"Fountain County, Indiana",18,045,18045
22645.0,718.0,471.0,19.0,18,9581,8549,3045,1965,1880,85,5504,4499,3955,544,8549,51190,0.4314,38.5,11165,22947,21338,264,153,26,7,1159,"Starke County, Indiana",18,149,18149
31844.0,1384.0,415.0,100.0,26,14111,12781,4233,2653,2523,130,8548,6661,6125,536,12781,51613,0.4064,38.4,15264,31864,29127,94,134,0,5,2504,"Greene County, Indiana",18,055,18055
25317.0,1245.0,212.0,7.0,34,13139,10306,3148,2035,1907,128,7158,5779,5414,365,10306,67729,0.4174,39.6,11144,25390,24641,96,88,4,12,549,"Benton County, Iowa",19,011,19011
95830.0,1700.0,3885.0,378.0,501,49887,38210,11029,6825,6542,283,27181,20469,18316,2153,38210,63031,0.4478,38.3,41299,95694,90041,975,1089,49,521,3019,"Dubuque County, Iowa",19,061,19061
6744.0,274.0,47.0,8.0,1,3296,3215,1071,572,566,6,2144,1561,1403,158,3215,52448,0.4083,41.9,3727,6647,6135,114,120,0,50,228,"Pocahontas County, Iowa",19,151,19151
7093.0,182.0,91.0,0.0,33,2979,2894,1044,666,636,30,1850,1355,1288,67,2894,48591,0.4593,39.2,3646,7091,6176,76,4,14,10,811,"Van Buren County, Iowa",19,177,19177
3627.0,116.0,28.0,0.0,7,1665,1598,596,301,275,26,1002,837,758,79,1598,49255,0.4291,41.7,2006,3608,3379,12,9,0,0,208,"Adams County, Iowa",19,003,19003
5532.0,181.0,109.0,0.0,4,2869,2649,889,539,520,19,1760,1201,1076,125,2649,52055,0.4013,41.0,3001,5446,5138,15,11,0,0,282,"Audubon County, Iowa",19,009,19009
8764.0,197.0,118.0,36.0,0,4072,3176,1058,604,591,13,2118,1774,1694,80,3176,63404,0.4315,40.0,3597,8811,6381,76,27,14,0,2313,"Davis County, Iowa",19,051,19051
6841.0,294.0,55.0,4.0,0,3365,3011,1010,645,581,64,2001,1475,1308,167,3011,58427,0.4565,42.0,3446,6779,6479,24,42,2,7,225,"Ida County, Iowa",19,093,19093
7676.0,393.0,81.0,0.0,5,3735,3294,1041,592,587,5,2253,1708,1583,125,3294,58269,0.4093,41.4,4011,7681,7323,43,7,0,0,308,"Monroe County, Iowa",19,135,19135
34276.0,614.0,910.0,112.0,35,18368,12248,3431,2090,2062,28,8817,7423,6966,457,12248,69844,0.3859,38.0,12928,34404,31616,546,812,4,697,729,"Sioux County, Iowa",19,167,19167
9630.0,782.0,146.0,6.0,18,4285,4146,1479,859,833,26,2667,2019,1839,180,4146,52323,0.4332,39.6,5072,9000,8599,55,27,12,27,280,"Calhoun County, Iowa",19,025,19025
42374.0,1309.0,876.0,326.0,113,21873,19241,6377,3450,3225,225,12864,9071,8232,839,19241,53963,0.4474,38.4,22348,42212,39351,522,281,38,165,1855,"Cerro Gordo County, Iowa",19,033,19033
16852.0,639.0,242.0,105.0,3,8343,7148,2438,1299,1259,40,4710,3455,3165,290,7148,54196,0.4164,39.8,8176,16514,15561,151,178,2,76,546,"Hardin County, Iowa",19,083,19083
8477.0,337.0,135.0,6.0,0,4044,3701,1258,763,730,33,2443,1893,1760,133,3701,55205,0.4504,39.6,4214,8466,7838,114,70,0,70,374,"Lucas County, Iowa",19,117,19117
8867.0,572.0,120.0,6.0,11,4486,3702,1266,650,633,17,2436,1857,1690,167,3702,52932,0.4108,39.3,4596,8808,8264,29,109,0,83,323,"Palo Alto County, Iowa",19,147,19147
19735.0,1100.0,374.0,18.0,7,9171,7743,2546,1512,1415,97,5197,4151,3912,239,7743,53501,0.3934,39.1,8373,18803,17487,413,301,15,64,523,"Henry County, Iowa",19,087,19087
36560.0,1899.0,516.0,31.0,74,17771,14574,4883,2933,2788,145,9691,7821,7248,573,14574,58952,0.3959,39.8,16298,35416,33914,324,115,6,92,965,"Jasper County, Iowa",19,099,19099
18261.0,969.0,617.0,110.0,4,9399,7767,2623,1380,1320,60,5144,3947,3450,497,7767,53852,0.4595,36.5,9134,18108,16693,134,254,0,106,921,"Poweshiek County, Iowa",19,157,19157
17480.0,294.0,337.0,6.0,11,8936,7510,2781,1515,1408,107,4729,3581,3237,344,7510,53152,0.4049,40.7,9122,17416,15972,192,229,19,12,992,"Clayton County, Iowa",19,043,19043
24628.0,1301.0,376.0,52.0,46,12980,9676,3199,1930,1905,25,6477,5272,4834,438,9676,70395,0.3864,38.0,10414,24540,23621,133,152,20,37,577,"Bremer County, Iowa",19,017,19017
9348.0,294.0,487.0,82.0,8,4614,4036,1325,704,693,11,2711,1963,1729,234,4036,51563,0.4333,37.8,4809,9170,8312,126,149,87,107,389,"Emmet County, Iowa",19,063,19063
10717.0,275.0,175.0,20.0,5,5627,4790,1595,959,935,24,3195,2579,2372,207,4790,61761,0.4012,40.6,5333,10647,10179,54,44,5,80,285,"Hancock County, Iowa",19,081,19081
19153.0,574.0,300.0,19.0,26,9433,8239,2788,1595,1520,75,5451,4309,3910,399,8239,55967,0.4186,40.6,9550,19200,18175,120,65,10,80,750,"Jackson County, Iowa",19,097,19097
33740.0,472.0,881.0,25.0,53,15414,14233,4447,2738,2656,82,9786,7351,6707,644,14233,49564,0.4199,39.1,16224,33046,31472,194,112,18,0,1250,"Lee County, Iowa",19,111,19111
49435.0,2823.0,879.0,68.0,53,25960,19258,5201,3174,3050,124,14057,11551,10831,720,19258,77048,0.4182,38.7,20004,49498,47497,521,156,0,118,1206,"Warren County, Iowa",19,181,19181
21956.0,767.0,405.0,41.0,57,10927,8927,2726,1637,1576,61,6201,4856,4394,462,8927,54825,0.4444,38.0,9869,21937,20546,160,266,0,5,960,"Mahaska County, Iowa",19,123,19123
15948.0,1037.0,383.0,75.0,65,7903,7212,2344,1241,1238,3,4868,3666,3264,402,7212,50521,0.4135,39.9,8232,15975,15034,138,201,2,57,543,"Clay County, Iowa",19,041,19041
17014.0,453.0,80.0,0.0,52,9157,6907,2268,1381,1350,31,4639,3755,3533,222,6907,63750,0.4305,41.3,8095,17019,16421,47,44,0,28,479,"Delaware County, Iowa",19,055,19055
11117.0,515.0,53.0,21.0,24,4088,3874,1221,725,679,46,2653,2167,2027,140,3874,37519,0.462,40.7,4797,10465,8188,44,75,28,221,1909,"Bacon County, Georgia",13,005,13005
18501.0,742.0,335.0,28.0,55,6714,6823,2284,1245,1215,30,4539,3542,3363,179,6823,38857,0.4322,40.4,8173,18645,15724,131,58,0,122,2610,"Brantley County, Georgia",13,025,13025
16833.0,445.0,190.0,21.0,0,6133,6443,2116,1174,1131,43,4327,3129,2888,241,6443,32229,0.4845,39.2,8001,16642,13431,129,126,27,247,2682,"Ben Hill County, Georgia",13,017,13017
22206.0,659.0,135.0,0.0,47,9217,8193,2375,1509,1495,14,5818,4651,4444,207,8193,44151,0.447,39.9,10064,22284,19274,192,67,32,244,2475,"Burke County, Georgia",13,033,13033
66150.0,2393.0,2641.0,2.0,10,30824,24778,7911,5200,4919,281,16867,13391,12509,882,24778,56235,0.4179,38.7,27359,66207,57551,632,438,95,356,7135,"Catoosa County, Georgia",13,047,13047
10328.0,895.0,3110.0,243.0,0,6353,2570,310,197,197,0,2260,1819,1689,130,2570,47096,0.4658,45.4,3341,6021,5386,101,161,11,6,356,"Chattahoochee County, Georgia",13,053,13053
24567.0,629.0,322.0,40.0,21,8827,9260,3170,1806,1730,76,6090,4496,4123,373,9260,36807,0.4476,40.8,10981,23107,19619,66,141,0,483,2798,"Chattooga County, Georgia",13,055,13055
148387.0,4594.0,4989.0,1539.0,85,70996,47215,12465,8537,8313,224,34750,28242,26723,1519,47215,82339,0.4004,39.2,57373,146892,126798,5353,3184,268,1728,9561,"Columbia County, Georgia",13,073,13073
26398.0,1684.0,374.0,22.0,75,10207,10084,2920,1887,1772,115,7164,5518,5341,177,10084,41481,0.479,39.7,12216,25375,20461,116,140,85,379,4194,"Decatur County, Georgia",13,087,13087
96396.0,3279.0,1592.0,172.0,157,41094,35679,11249,7101,6904,197,24430,19302,18042,1260,35679,48336,0.475,38.7,40599,95194,78613,1577,2193,492,2512,9807,"Floyd County, Georgia",13,115,13115
225823.0,11265.0,5716.0,1332.0,632,113448,76753,18103,13493,13057,436,58650,52111,49663,2448,76753,107218,0.4017,39.5,80937,227772,175357,16207,16120,1264,6354,12470,"Forsyth County, Georgia",13,117,13117
44215.0,2570.0,473.0,372.0,115,18317,15139,5783,3553,3381,172,9356,7536,7059,477,15139,50563,0.4348,39.0,18442,42978,33889,1051,1225,281,1476,5056,"Habersham County, Georgia",13,137,13137
25410.0,1085.0,359.0,70.0,20,9752,9853,3913,2741,2599,142,5940,4420,4144,276,9853,43204,0.4498,38.2,13168,24835,21523,257,61,15,122,2857,"Hart County, Georgia",13,147,13147
113976.0,3450.0,4347.0,644.0,148,49990,41282,9836,5881,5592,289,31446,23217,20313,2904,41282,42441,0.5179,37.8,47654,109929,90704,1571,1317,303,649,15385,"Lowndes County, Georgia",13,185,13185
14040.0,514.0,253.0,4.0,17,6060,6042,2794,1934,1875,59,3248,2428,2190,238,6042,49504,0.4294,39.6,9554,14033,11775,165,0,11,52,2030,"McIntosh County, Georgia",13,191,13191
20885.0,1168.0,138.0,7.0,31,7915,8051,3161,2241,2188,53,4890,3509,3316,193,8051,37121,0.4689,40.0,9997,21019,18011,63,42,0,94,2809,"Meriwether County, Georgia",13,199,13199
26917.0,1472.0,413.0,6.0,6,11073,9760,3388,1959,1832,127,6372,4610,4347,263,9760,54754,0.5327,38.6,11129,26086,22342,386,232,34,104,2988,"Monroe County, Georgia",13,207,13207
21493.0,1246.0,309.0,69.0,0,9349,8937,3571,2450,2356,94,5366,4278,3926,352,8937,51606,0.4855,39.9,13148,21488,18056,279,148,81,316,2608,"Putnam County, Georgia",13,237,13237
29710.0,1433.0,161.0,60.0,5,11483,11510,3620,2311,2135,176,7890,5389,5121,268,11510,36681,0.4751,39.1,13891,29156,24652,353,679,67,222,3183,"Sumter County, Georgia",13,261,13261
1589.0,52.0,8.0,0.0,0,600,593,239,185,179,6,354,242,220,22,593,37446,0.4557,39.1,1020,1609,1405,5,20,19,21,139,"Taliaferro County, Georgia",13,265,13265
5254.0,147.0,31.0,0.0,2,2078,2244,795,484,476,8,1449,1019,980,39,2244,37203,0.5202,39.5,2976,5225,4527,19,2,8,43,626,"Warren County, Georgia",13,301,13301
6323.0,127.0,173.0,2.0,20,2750,2689,966,506,486,20,1723,1314,1219,95,2689,44768,0.4417,41.0,3214,6334,5545,46,34,2,0,707,"Wayne County, Iowa",19,185,19185
170560.0,2060.0,5104.0,637.0,575,83398,67021,18919,10985,10176,809,48102,35504,31922,3582,67021,61183,0.4614,38.8,74232,170759,156732,3158,3129,202,672,6866,"Scott County, Iowa",19,163,19163
5874.0,174.0,183.0,0.0,0,2803,2544,772,412,396,16,1772,1280,1228,52,2544,54754,0.4057,41.0,3128,5861,5170,62,96,0,55,478,"Sherman County, Kansas",20,181,20181
7738.0,451.0,364.0,22.0,0,4156,3375,850,585,564,21,2525,1941,1697,244,3375,60124,0.4769,39.4,3593,7701,6839,113,104,0,190,455,"Thomas County, Kansas",20,193,20193
5527.0,193.0,94.0,10.0,5,2668,2280,884,603,592,11,1396,1106,1011,95,2280,55658,0.4262,41.2,3215,5482,4962,32,41,0,26,421,"Morris County, Kansas",20,127,20127
5007.0,141.0,35.0,6.0,0,2442,2176,783,386,369,17,1393,1047,978,69,2176,49415,0.4012,39.9,2746,4867,4505,27,3,0,6,326,"Rooks County, Kansas",20,163,20163
2013.0,86.0,59.0,0.0,0,961,873,318,169,161,8,555,437,391,46,873,53348,0.3879,42.9,1137,1963,1822,15,26,6,0,94,"Clark County, Kansas",20,025,20025
5501.0,212.0,134.0,1.0,0,2331,2265,796,456,446,10,1469,1117,1040,77,2265,49865,0.4152,42.5,3177,5442,4690,12,34,0,39,667,"Harper County, Kansas",20,077,20077
32908.0,1918.0,614.0,153.0,89,16790,13569,3306,2085,1918,167,10263,7503,6077,1426,13569,46338,0.4692,38.0,15334,32850,27607,821,1567,150,844,1861,"Lyon County, Kansas",20,111,20111
6571.0,998.0,131.0,8.0,0,2691,2448,795,572,560,12,1653,914,855,59,2448,49917,0.3951,40.2,3157,5575,4982,28,32,0,5,528,"Pawnee County, Kansas",20,145,20145
1738.0,56.0,0.0,4.0,0,916,751,298,168,168,0,453,312,290,22,751,54821,0.427,41.5,983,1668,1514,4,2,0,5,143,"Comanche County, Kansas",20,033,20033
2613.0,92.0,49.0,4.0,0,1264,1217,442,273,271,2,775,583,534,49,1217,48317,0.4142,42.7,1409,2597,2259,14,8,6,23,287,"Gove County, Kansas",20,063,20063
34101.0,1379.0,869.0,79.0,7,16806,13290,4321,2623,2537,86,8969,6994,6548,446,13290,57982,0.3984,40.0,14775,33843,30350,318,404,28,472,2271,"Harvey County, Kansas",20,079,20079
3840.0,124.0,152.0,108.0,0,1642,1201,377,249,246,3,824,720,653,67,1201,52599,0.4552,41.3,1567,3847,2956,183,124,0,206,378,"Kearny County, Kansas",20,093,20093
28277.0,977.0,665.0,138.0,10,14548,12334,3712,2158,2088,70,8622,6428,5918,510,12334,59089,0.4087,39.4,13258,27840,25728,125,186,84,33,1684,"McPherson County, Kansas",20,113,20113
11540.0,368.0,94.0,33.0,9,4518,5204,1656,1052,1030,22,3548,2687,2515,172,5204,31893,0.4547,40.6,6324,11644,10668,72,167,18,164,555,"Desha County, Arkansas",05,041,05041
12095.0,531.0,428.0,34.0,51,4062,4973,2320,1395,1339,56,2653,2159,1939,220,4973,35405,0.4256,40.3,6842,12062,10486,85,32,0,85,1374,"Fulton County, Arkansas",05,049,05049
13145.0,311.0,189.0,0.0,70,5505,5142,1627,928,907,21,3515,2700,2596,104,5142,36059,0.511,39.1,6262,13142,11534,212,271,0,377,748,"Howard County, Arkansas",05,061,05061
97568.0,3117.0,2931.0,117.0,213,40327,40209,16036,9296,8758,538,24173,18067,16492,1575,40209,44777,0.4807,38.7,50869,97346,85127,1137,856,335,1402,8489,"Garland County, Arkansas",05,051,05051
41576.0,1474.0,1306.0,46.0,56,16733,16389,4526,2552,2447,105,11863,9040,8188,852,16389,39962,0.4727,40.4,20559,41376,37777,230,292,19,205,2853,"Mississippi County, Arkansas",05,093,05093
63007.0,3472.0,712.0,240.0,159,26270,22579,6648,3997,3871,126,15931,12174,11010,1164,22579,43462,0.4696,38.4,26280,63168,55367,830,1531,13,1056,4371,"Pope County, Arkansas",05,115,05115
8100.0,400.0,72.0,0.0,0,3375,3776,1465,759,744,15,2311,1801,1751,50,3776,42660,0.4579,41.7,4558,8052,7418,7,0,0,11,616,"Prairie County, Arkansas",05,117,05117
38931.0,681.0,906.0,46.0,76,15422,15726,4940,3081,2956,125,10786,7920,7606,314,15726,44663,0.47,39.4,20031,39087,35642,218,296,11,197,2723,"Union County, Arkansas",05,139,05139
6481.0,225.0,40.0,16.0,15,2636,2932,1008,598,527,71,1924,1450,1328,122,2932,32845,0.5001,42.4,3878,6418,6004,2,27,0,0,385,"Woodruff County, Arkansas",05,147,05147
24927.0,899.0,412.0,1.0,0,10046,10783,4532,2829,2760,69,6251,4817,4470,347,10783,44483,0.4501,39.8,16095,24779,22584,50,116,71,109,1849,"Cleburne County, Arkansas",05,023,05023
8063.0,167.0,20.0,0.0,4,2984,3217,1137,687,687,0,2080,1597,1567,30,3217,46684,0.4257,42.3,4131,8034,7577,10,3,0,56,388,"Cleveland County, Arkansas",05,025,05025
16930.0,2211.0,382.0,3.0,0,5499,6137,2200,1192,1154,38,3937,2851,2604,247,6137,34109,0.501,40.1,7592,14380,13208,60,0,0,0,1112,"Jackson County, Arkansas",05,067,05067
21547.0,505.0,496.0,10.0,37,9032,8094,2671,1784,1741,43,5423,4330,3970,360,8094,42860,0.4199,39.5,10533,21590,19198,194,223,16,586,1373,"Hempstead County, Arkansas",05,057,05057
17015.0,1051.0,366.0,18.0,0,5859,7447,3255,1899,1764,135,4192,2852,2656,196,7447,34671,0.4769,39.6,9882,16967,15811,44,39,12,34,1027,"Sharp County, Arkansas",05,135,05135
12335.0,184.0,205.0,0.0,0,4439,4787,2113,1182,1066,116,2674,2113,2043,70,4787,38188,0.4609,36.1,6919,12361,11331,76,17,0,0,937,"Stone County, Arkansas",05,137,05137
228914.0,9692.0,9424.0,1142.0,733,109913,87325,18604,11603,10988,615,68721,52123,44011,8112,87325,50451,0.4851,38.2,93611,230371,186918,5917,10850,684,8096,17906,"Washington County, Arkansas",05,143,05143
41043.0,1328.0,1118.0,124.0,1,15791,18435,8734,5503,5306,197,9701,7318,6658,660,18435,42260,0.4517,38.5,22887,41071,38232,559,128,4,3,2145,"Baxter County, Arkansas",05,005,05005
20026.0,167.0,232.0,28.0,23,7666,7757,2858,1840,1793,47,4899,3807,3661,146,7757,44744,0.4694,38.9,10183,20123,18301,87,165,16,231,1323,"Ashley County, Arkansas",05,003,05003
106145.0,6314.0,1958.0,648.0,253,48636,41375,10318,6140,5859,281,31057,23381,20905,2476,41375,47286,0.4816,39.0,45413,106293,94014,1111,1840,54,1278,7996,"Craighead County, Arkansas",05,031,05031
44439.0,2052.0,1374.0,39.0,18,18088,17254,4897,3125,3046,79,12357,10014,9234,780,17254,47056,0.4261,40.1,19007,44420,40721,48,219,0,66,3366,"Greene County, Arkansas",05,055,05055
10201.0,417.0,190.0,5.0,0,3717,3668,1382,1010,980,30,2286,1917,1844,73,3668,48667,0.4132,38.3,4974,10248,9678,15,34,9,1,511,"Perry County, Arkansas",05,105,05105
23601.0,1318.0,404.0,11.0,4,9626,9526,2871,1942,1874,68,6655,5088,4836,252,9526,40921,0.4285,39.7,10998,23560,20767,45,83,24,82,2559,"Poinsett County, Arkansas",05,111,05111
16891.0,273.0,103.0,4.0,16,7161,5885,1636,1014,957,57,4249,3482,3322,160,5885,47704,0.4595,39.3,6979,16962,12791,405,921,144,1323,1378,"Sevier County, Arkansas",05,133,05133
5187.0,261.0,22.0,8.0,5,2101,1850,765,512,504,8,1085,808,798,10,1850,46417,0.4212,39.5,2929,5147,4639,17,12,20,8,451,"Calhoun County, Arkansas",05,013,05013
22133.0,2173.0,570.0,61.0,82,10449,8446,2573,1479,1379,100,5873,4537,3874,663,8446,41620,0.4319,36.6,10533,22049,19816,176,178,0,266,1613,"Clark County, Arkansas",05,019,05019
16432.0,749.0,401.0,14.0,4,6458,6463,2107,1312,1276,36,4356,3464,3190,274,6463,39993,0.4382,40.4,8005,16250,15083,42,60,0,28,1037,"Lawrence County, Arkansas",05,075,05075
6992.0,596.0,196.0,3.0,0,2864,3333,1287,621,612,9,2046,1430,1362,68,3333,38468,0.4556,40.6,4422,6971,6325,21,2,0,0,623,"Monroe County, Arkansas",05,095,05095
20647.0,504.0,262.0,28.0,0,8887,8309,2817,1563,1485,78,5492,4325,4115,210,8309,42802,0.4812,40.0,9828,20767,19012,186,152,0,167,1250,"Conway County, Arkansas",05,029,05029
7772.0,240.0,78.0,0.0,0,2841,2936,1303,736,693,43,1633,1155,1107,48,2936,38082,0.4307,36.4,4690,7740,7260,38,57,0,0,385,"Newton County, Arkansas",05,101,05101
17692.0,598.0,221.0,17.0,2,7760,7491,2428,1460,1398,62,5063,3777,3325,452,7491,46696,0.4807,41.5,9468,17673,16358,66,42,0,37,1170,"Arkansas County, Arkansas",05,001,05001
71652.0,2810.0,1122.0,437.0,63,32734,26895,6692,4315,4184,131,20203,16492,15707,785,26895,59094,0.4161,40.4,29387,71226,64652,692,501,115,308,4958,"Lonoke County, Arkansas",05,085,05085
27759.0,432.0,572.0,87.0,5,11827,11139,4344,2766,2621,145,6795,5255,4876,379,11139,46110,0.4631,39.6,13723,27746,23463,665,530,117,1094,1877,"Carroll County, Arkansas",05,015,05015
25603.0,804.0,392.0,124.0,1,8390,9388,2999,1805,1753,52,6389,4427,4114,313,9388,35348,0.4908,38.6,10990,22635,20495,19,182,0,61,1878,"St. Francis County, Arkansas",05,123,05123
388365.0,11692.0,8365.0,1348.0,1545,184277,158051,41955,24102,23340,762,116096,80834,72473,8361,158051,51749,0.509,39.3,184319,386447,341611,7296,6994,1184,5802,23560,"Pulaski County, Arkansas",05,119,05119
267939.0,11721.0,2179.0,1611.0,1177,100895,80008,21334,14729,14194,535,58674,50370,46855,3515,80008,53672,0.4719,38.7,85251,268611,187416,26391,32427,1580,10496,10301,"Merced County, California",06,047,06047
17309.0,831.0,306.0,13.0,137,6785,7643,3418,2159,2021,138,4225,3083,2780,303,7643,48820,0.4234,37.5,10411,17256,15396,471,420,5,114,850,"Mariposa County, California",06,043,06043
8831.0,521.0,273.0,8.0,0,2921,3616,1626,962,863,99,1990,1387,1268,119,3616,45507,0.4003,39.6,5258,8698,7035,174,398,26,34,1031,"Modoc County, California",06,049,06049
1130383.0,45496.0,12478.0,9642.0,59068,544376,394769,122004,82557,77668,4889,272765,225980,207138,18842,394769,99716,0.4672,38.1,413719,1137149,819792,152456,106928,5694,24267,28012,"Contra Costa County, California",06,013,06013
17813.0,716.0,487.0,22.0,59,8053,7950,3012,1737,1680,57,4938,3040,2616,424,7950,57316,0.4104,37.5,9572,17607,15157,831,602,29,133,855,"Inyo County, California",06,027,06027
535794.0,16377.0,3095.0,2552.0,1854,221055,173898,49378,34065,32206,1859,124520,104187,96698,7489,173898,60704,0.4396,38.3,181748,540181,412755,47631,49106,2558,10677,17454,"Stanislaus County, California",06,099,06099
439942.0,18009.0,8253.0,4637.0,6277,209569,145856,46245,29328,27013,2315,99611,81936,68928,13008,145856,74624,0.4815,37.1,157161,437669,320051,32622,41118,2188,25509,16181,"Santa Barbara County, California",06,083,06083
63154.0,3358.0,589.0,90.0,66,24008,24189,8459,5380,5020,360,15730,12376,11099,1277,24189,44514,0.4656,38.4,27558,63391,55152,2279,1938,286,833,2903,"Tehama County, California",06,103,06103
14124.0,453.0,92.0,416.0,1770,8302,4765,1454,942,887,55,3311,2161,1616,545,4765,62260,0.415,38.4,14116,14198,10552,488,873,336,1116,833,"Mono County, California",06,051,06051
59528.0,3099.0,412.0,253.0,177,28376,18135,5291,4113,3794,319,12844,11417,10794,623,18135,86958,0.4054,38.4,18970,60212,45981,5074,4635,258,2000,2264,"San Benito County, California",06,069,06069
36636.0,2404.0,1715.0,246.0,4,16992,13048,2747,1777,1672,105,10301,8869,8468,401,13048,72624,0.428,40.3,14292,35690,30714,790,412,78,286,3410,"Bryan County, Georgia",13,029,13029
23882.0,3259.0,194.0,118.0,0,9301,8279,2601,1620,1522,98,5678,4678,4301,377,8279,43471,0.5216,39.8,9429,21244,18295,276,333,0,18,2322,"Butts County, Georgia",13,035,13035
52440.0,2095.0,4167.0,189.0,43,25204,19338,4812,3513,3370,143,14526,11977,11010,967,19338,56951,0.4535,41.9,22044,49044,41277,1048,722,148,424,5425,"Camden County, Georgia",13,039,13039
12094.0,736.0,178.0,33.0,61,4619,4510,1530,1049,1015,34,2980,2235,2107,128,4510,46283,0.4662,38.2,5362,12189,10521,79,2,10,26,1551,"Crawford County, Georgia",13,079,13079
10270.0,423.0,111.0,1.0,12,3670,4074,1474,748,745,3,2600,2053,1914,139,4074,30640,0.4996,39.0,4978,10158,8325,85,38,7,0,1703,"Early County, Georgia",13,099,13099
42600.0,1329.0,690.0,104.0,26,16662,14438,4137,2543,2424,119,10301,7910,7489,421,14438,40859,0.4783,39.7,17286,39642,31103,692,477,212,1235,5923,"Coffee County, Georgia",13,069,13069
141666.0,5125.0,3225.0,389.0,437,69662,52035,13790,9652,9270,382,38245,31551,29260,2291,52035,75913,0.419,39.8,54626,142697,122728,3298,2811,516,1474,11870,"Coweta County, Georgia",13,077,13077
30066.0,1412.0,811.0,115.0,23,12753,12021,5040,3628,3444,184,6981,5193,4584,609,12021,52625,0.4561,38.6,17130,30217,23329,391,477,152,1095,4773,"Gilmer County, Georgia",13,123,13123
90443.0,4630.0,1619.0,367.0,54,41094,31670,9345,6497,6246,251,22325,19048,18181,867,31670,61599,0.4221,39.2,33794,90570,76648,2433,869,273,791,9556,"Walton County, Georgia",13,297,13297
9806.0,399.0,66.0,4.0,9,4025,3979,1647,849,842,7,2332,1635,1579,56,3979,37838,0.5082,39.4,5165,9754,8198,78,45,5,191,1237,"Wilkes County, Georgia",13,317,13317
20700.0,1348.0,92.0,45.0,46,7764,7628,2429,1532,1402,130,5199,3900,3765,135,7628,39302,0.469,38.3,9848,18900,16716,71,125,16,80,1892,"Dodge County, Georgia",13,091,13091
56587.0,1727.0,491.0,205.0,189,25787,20561,6086,3607,3488,119,14475,12197,11514,683,20561,45865,0.4646,40.0,22614,56666,45491,1028,1453,183,2160,6351,"Gordon County, Georgia",13,129,13129
244461.0,11049.0,4346.0,755.0,644,125757,88137,23273,15868,15426,442,64864,54604,50734,3870,88137,82740,0.4078,39.8,92193,246374,205614,8169,6097,1397,6145,18952,"Cherokee County, Georgia",13,057,13057
111567.0,4093.0,3725.0,783.0,453,52476,40285,13598,9455,9272,183,26687,22811,21848,963,40285,90145,0.4369,39.6,42530,111684,94028,5833,3763,425,1348,6287,"Fayette County, Georgia",13,113,13113
29177.0,1760.0,493.0,68.0,0,13156,10226,2686,1824,1802,22,7540,6317,6070,247,10226,69280,0.397,40.1,11203,28446,24658,808,122,28,80,2750,"Lee County, Georgia",13,177,13177
31162.0,1761.0,570.0,15.0,73,14071,11868,4566,3158,3069,89,7302,5938,5470,468,11868,67631,0.4204,39.8,13981,31090,27319,274,194,65,178,3060,"Pickens County, Georgia",13,227,13227
17236.0,741.0,357.0,9.0,29,6379,7132,3311,2330,2280,50,3821,2884,2695,189,7132,52129,0.5604,38.8,9753,17195,14205,230,180,34,325,2221,"Greene County, Georgia",13,133,13133
16821.0,532.0,93.0,66.0,12,7083,6217,1986,1110,1040,70,4231,3408,3203,205,6217,41854,0.4604,39.6,7419,17080,13803,34,177,60,161,2845,"Cook County, Georgia",13,075,13075
24400.0,1236.0,451.0,18.0,0,11953,9041,3347,2348,2282,66,5694,4454,4209,245,9041,66281,0.4338,39.5,11464,24322,20632,478,264,80,98,2770,"Dawson County, Georgia",13,085,13085
1023679.0,48731.0,36644.0,10846.0,39488,526522,410576,86094,48272,45703,2569,324482,205548,174742,30806,410576,69673,0.5414,40.0,471836,1026404,811509,52622,56534,4065,21691,79983,"Fulton County, Georgia",13,121,13121
197216.0,1804.0,6230.0,1073.0,1112,86037,69453,27975,19080,17699,1381,41478,31844,28549,3295,69453,62409,0.4708,37.3,87824,197924,166044,11637,10447,533,2562,6701,"Hawaii County, Hawaii",15,001,15001
972023.0,3324.0,38848.0,12476.0,40274,500034,312795,112763,81346,77333,4013,200032,156242,141585,14657,312795,85857,0.4336,39.2,350571,935813,725396,110715,68472,3876,7277,20077,"Honolulu County, Hawaii",15,003,15003
70905.0,684.0,1859.0,678.0,219,35697,22658,9106,6585,6138,447,13552,10880,9786,1094,22658,83554,0.4161,38.2,31016,71049,56654,6210,4629,283,847,2426,"Kauai County, Hawaii",15,007,15007
65.0,6.0,0.0,1.0,1,51,39,4,2,2,0,35,11,7,4,39,69375,0.3124,41.2,94,61,58,2,1,0,0,0,"Kalawao County, Hawaii",15,005,15005
23303.0,1319.0,676.0,124.0,28,9917,7711,2181,1577,1530,47,5530,4733,4517,216,7711,52935,0.4115,40.8,8747,23371,18788,539,878,94,1000,2072,"Cassia County, Idaho",16,031,16031
5284.0,220.0,50.0,47.0,33,2507,1724,473,273,262,11,1251,1050,1002,48,1724,50053,0.4175,41.1,2001,5295,3824,106,220,43,455,647,"Lincoln County, Idaho",16,063,16063
10525.0,357.0,683.0,6.0,47,4701,3869,1691,1220,1182,38,2178,1747,1583,164,3869,64475,0.4613,37.9,12373,10624,9340,48,23,0,0,1213,"Valley County, Idaho",16,085,16085
13331.0,324.0,1008.0,43.0,54,5777,4397,1304,877,874,3,3093,2748,2619,129,4397,57215,0.3944,37.3,4837,13423,11786,116,58,6,160,1297,"Franklin County, Idaho",16,041,16041
39748.0,1155.0,1647.0,17.0,32,18924,16384,5305,3477,3288,189,11079,8259,7446,813,16384,58107,0.4223,38.4,17829,39640,34984,581,84,20,80,3891,"Nez Perce County, Idaho",16,069,16069
155856.0,2010.0,6928.0,313.0,230,71889,62304,19911,12890,12185,705,42393,33527,30240,3287,62304,57242,0.4278,37.8,70892,156102,137964,2034,952,219,572,14361,"Kootenai County, Idaho",16,055,16055
20437.0,1134.0,494.0,153.0,9,9426,7250,2109,1482,1425,57,5141,4260,4058,202,7250,53370,0.4463,42.4,8201,20655,15404,722,762,322,1168,2277,"Minidoka County, Idaho",16,067,16067
83478.0,2983.0,3089.0,120.0,72,39504,31146,8603,5535,5253,282,22543,17755,16327,1428,31146,52919,0.4369,38.9,33282,84069,68584,2244,3143,351,1851,7896,"Twin Falls County, Idaho",16,083,16083
22203.0,336.0,838.0,102.0,211,12150,7995,2657,1629,1579,50,5338,3610,3407,203,7995,56694,0.4757,39.0,15442,22348,17694,829,955,266,1456,1148,"Blaine County, Idaho",16,013,16013
7335.0,534.0,137.0,63.0,0,2925,3205,1248,979,865,114,1957,1495,1377,118,3205,59646,0.4139,40.4,5554,7351,6332,99,87,8,43,782,"Boise County, Idaho",16,015,16015
2553.0,43.0,138.0,2.0,13,950,967,366,233,226,7,601,430,421,9,967,42132,0.5235,38.0,1288,2539,2132,10,4,0,3,390,"Butte County, Idaho",16,023,16023
14971.0,508.0,336.0,19.0,19,6922,5469,1819,1168,1111,57,3650,3038,2729,309,5469,47204,0.4134,42.3,6231,15060,11759,334,545,124,943,1355,"Gooding County, Idaho",16,047,16047
452597.0,9184.0,20270.0,1903.0,910,227064,173353,44093,26720,25449,1271,129260,95244,84616,10628,173353,66293,0.4615,38.3,181533,449074,390022,11954,9964,1583,2750,32801,"Ada County, Idaho",16,001,16001
5930.0,215.0,172.0,33.0,13,2510,2424,870,583,567,16,1554,1293,1241,52,2424,54167,0.4051,38.4,4118,5962,5461,86,74,24,0,317,"Bear Lake County, Idaho",16,007,16007
45150.0,1460.0,1339.0,124.0,529,19359,14989,4550,3014,2949,65,10439,8645,8250,395,14989,55472,0.4048,38.9,16745,45590,39352,801,636,85,703,4013,"Bingham County, Idaho",16,011,16011
1038.0,34.0,60.0,6.0,0,493,394,136,71,71,0,258,185,169,16,394,39688,0.5179,40.8,803,1048,921,0,0,8,14,105,"Camas County, Idaho",16,025,16025
8606.0,528.0,270.0,27.0,11,2802,3555,1622,948,902,46,1933,1433,1221,212,3555,43915,0.4242,39.9,4625,7742,6695,62,79,14,11,881,"Clearwater County, Idaho",16,035,16035
28068.0,1257.0,998.0,56.0,351,12764,8791,1965,1455,1429,26,6826,5959,5597,362,8791,63048,0.3712,38.5,9369,28513,25211,215,542,0,314,2231,"Jefferson County, Idaho",16,051,16051
370022.0,10527.0,14738.0,2173.0,4957,170333,152312,49638,30755,28389,2366,102674,76406,61266,15140,152312,52426,0.4665,36.1,162611,371607,327930,8781,8806,497,3380,22213,"Lane County, Oregon",41,039,41039
6467.0,201.0,115.0,0.0,87,3039,2730,1034,671,667,4,1696,1351,1244,107,2730,57962,0.401,39.6,3575,6517,5695,22,29,20,0,751,"Surry County, Virginia",51,181,51181
14300.0,836.0,270.0,21.0,37,7082,5612,1978,1316,1264,52,3634,2852,2631,221,5612,80026,0.4549,38.1,6345,14254,12108,159,182,100,58,1647,"Clarke County, Virginia",51,043,51043
30350.0,703.0,658.0,20.0,51,11928,12075,5235,3179,3046,133,6840,4878,4660,218,12075,43207,0.4686,39.8,18983,29803,26499,177,95,37,412,2583,"Mecklenburg County, Virginia",51,117,51117
74550.0,3933.0,948.0,178.0,83,34651,29539,10707,7197,6937,260,18832,15004,14020,984,29539,62711,0.41,39.3,32541,70843,63986,752,538,66,389,5112,"Augusta County, Virginia",51,015,51015
22749.0,1714.0,317.0,36.0,26,10858,8506,3277,2288,2231,57,5229,4139,3901,238,8506,93994,0.4975,39.4,9290,21736,19876,642,155,0,141,922,"Goochland County, Virginia",51,075,51075
13017.0,574.0,110.0,32.0,88,6080,4949,1768,1179,1132,47,3181,2505,2398,107,4949,57895,0.4324,39.8,6079,13020,11327,155,180,33,22,1303,"Madison County, Virginia",51,113,51113
93159.0,4656.0,1768.0,416.0,123,45182,38222,13409,8196,7906,290,24813,19399,17915,1484,38222,68948,0.4265,39.6,40924,92166,82792,2834,1577,267,586,4110,"Roanoke County, Virginia",51,161,51161
16347.0,925.0,351.0,26.0,10,5882,6037,2462,1462,1423,39,3575,2574,2329,245,6037,44434,0.423,37.8,8231,14453,13070,67,175,2,27,1112,"Brunswick County, Virginia",51,025,51025
11799.0,193.0,153.0,3.0,60,4807,5148,2168,1231,1153,78,2980,2111,1958,153,5148,47227,0.4639,39.4,7396,11618,9804,342,206,0,94,1172,"Northampton County, Virginia",51,131,51131
22384.0,799.0,319.0,66.0,31,9715,9248,3897,2462,2265,197,5351,4239,3952,287,9248,54600,0.452,38.6,11441,22364,20053,293,148,30,50,1790,"Rockbridge County, Virginia",51,163,51163
3921.0,799.0,114.0,0.0,60,1596,1628,493,158,158,0,1135,889,810,79,1628,29000,0.509,40.4,1903,3913,3354,91,37,18,0,413,"Norton city, Virginia",51,720,51720
17322.0,1847.0,276.0,82.0,70,7588,7036,2572,1580,1539,41,4464,3154,2905,249,7036,54550,0.4236,38.1,7734,17297,14988,768,252,110,145,1034,"Colonial Heights city, Virginia",51,570,51570
6373.0,501.0,56.0,0.0,13,2285,2367,1033,674,665,9,1334,1070,1064,6,2367,48531,0.4122,39.5,3325,5486,5062,6,7,0,0,411,"Bland County, Virginia",51,021,51021
33175.0,1033.0,440.0,113.0,0,15861,13264,4886,3326,3166,160,8378,6773,6472,301,13264,71110,0.4114,39.5,14884,33003,30917,457,272,2,17,1338,"Botetourt County, Virginia",51,023,51023
16721.0,776.0,915.0,12.0,59,6886,7334,2651,1323,1261,62,4683,3237,2971,266,7334,37500,0.4741,36.5,8727,16738,14901,104,19,18,35,1661,"Bristol city, Virginia",51,520,51520
14875.0,2453.0,1275.0,462.0,218,6278,4706,1553,933,885,48,3153,1871,1311,560,4706,57463,0.5088,31.2,5263,14696,12946,344,536,23,110,737,"Williamsburg city, Virginia",51,830,51830
29506.0,473.0,482.0,107.0,4,12835,12357,4954,3085,3005,80,7403,5535,5154,381,12357,44835,0.4559,39.1,16749,29645,26157,132,209,100,159,2888,"Carroll County, Virginia",51,035,51035
1506017.0,54553.0,17599.0,10960.0,17063,689904,543025,148174,95600,88851,6749,394851,304921,269693,35228,543025,67151,0.4538,37.6,570752,1510932,1145718,174292,108168,8671,26657,47426,"Sacramento County, California",06,067,06067
186935.0,12501.0,2836.0,710.0,1204,83461,70974,25784,17798,16711,1087,45190,36375,33038,3337,70974,83377,0.4556,37.6,90333,187280,163172,10016,5521,321,1426,6824,"El Dorado County, California",06,017,06017
427743.0,14007.0,8184.0,3562.0,3006,189872,127155,39506,26546,24935,1611,87649,73090,66907,6183,127155,71015,0.457,39.0,141820,417249,276744,33763,65747,1466,25637,13892,"Monterey County, California",06,053,06053
865937.0,31944.0,20124.0,11684.0,178167,512455,362354,97400,57270,52842,4428,264954,176013,120816,55197,362354,112449,0.5099,40.4,397812,870863,555059,184155,99746,4962,9849,17092,"San Francisco County, California",06,075,06075
3274227.0,51601.0,78640.0,36713.0,48043,1627544,1125286,311874,210346,196174,14172,813412,646474,560789,85685,1125286,78980,0.4627,38.6,1213891,3216326,2311304,389154,263832,25670,87537,138829,"San Diego County, California",06,073,06073
455142.0,8517.0,2052.0,1661.0,1192,173640,138238,36089,24676,23857,819,102149,88161,82593,5568,138238,49687,0.4728,38.8,148994,457857,339734,31820,49186,2321,16962,17834,"Tulare County, California",06,107,06107
134460.0,6278.0,2786.0,397.0,1063,59460,54679,16967,9800,8757,1043,37712,27306,21422,5884,54679,48041,0.4841,35.8,63089,135003,117851,3355,2703,85,999,10010,"Humboldt County, California",06,023,06023
1027.0,17.0,30.0,7.0,2,330,350,195,133,130,3,155,116,101,15,350,63750,0.493,34.5,1767,1039,913,30,4,0,19,73,"Alpine County, California",06,003,06003
153658.0,7038.0,969.0,391.0,264,54942,44881,14385,10548,10210,338,30496,26482,25023,1459,44881,57585,0.4422,38.4,50677,147253,110458,8819,15774,589,5270,6343,"Madera County, California",06,039,06039
271214.0,13320.0,3595.0,1553.0,3997,132921,95818,31133,19891,17944,1947,64685,50802,42693,8109,95818,82234,0.4819,36.0,106307,272491,215842,18558,24102,1001,4826,8162,"Santa Cruz County, California",06,087,06087
12565.0,533.0,250.0,15.0,57,4257,5939,2573,1582,1408,174,3366,2330,2017,313,5939,40846,0.4638,37.9,8918,12529,10809,249,160,19,144,1148,"Trinity County, California",06,105,06105
2382905.0,88981.0,26500.0,11562.0,12639,1009081,724893,229418,156982,146940,10042,495475,408365,380145,28220,724893,67005,0.4572,37.8,840501,2389375,1754887,241779,183420,20809,70555,117925,"Riverside County, California",06,065,06065
2122337.0,85122.0,25375.0,9537.0,12532,904677,636041,171073,123846,118043,5803,464968,393514,368242,25272,636041,63362,0.4375,37.9,720757,2099054,1560893,206237,155378,16185,66483,93878,"San Bernardino County, California",06,071,06071
257828.0,13948.0,3731.0,2419.0,12346,128161,105432,40263,23370,21040,2330,65169,50514,45012,5502,105432,115246,0.5178,38.3,113084,255421,204860,22008,19566,485,4388,4114,"Marin County, California",06,041,06041
382187.0,20185.0,6640.0,1597.0,1906,175805,142855,50189,32506,30824,1682,92666,75905,69592,6313,142855,89691,0.4467,37.9,164176,382926,326937,27467,13078,885,2299,12260,"Placer County, California",06,061,06061
177291.0,6232.0,2308.0,629.0,421,72331,71181,25534,16045,15064,981,45647,35324,31276,4048,71181,54667,0.4588,37.2,78634,177761,157722,4661,3832,393,900,10253,"Shasta County, California",06,089,06089
437433.0,22851.0,6130.0,2773.0,6552,205287,149865,46380,32536,30611,1925,103485,84126,76866,7260,149865,81472,0.4207,38.1,157800,429483,328755,50383,30079,1777,5346,13143,"Solano County, California",06,095,06095
21213.0,943.0,175.0,21.0,14,9469,7227,2173,1287,1251,36,5054,4385,4076,309,7227,59401,0.4554,43.3,8044,21291,14707,2171,2321,184,1105,803,"Colusa County, California",06,011,06011
28132.0,814.0,343.0,71.0,7,10485,9414,3079,1944,1919,25,6335,4838,4690,148,9414,42151,0.454,38.3,12333,28352,24401,77,101,167,111,3495,"Copiah County, Mississippi",28,029,28029
236090.0,7872.0,4397.0,592.0,565,102746,88611,23511,14458,13903,555,65100,45763,41334,4429,88611,44625,0.4692,38.4,104284,236360,204791,1091,1178,287,1368,27645,"Hinds County, Mississippi",28,049,28049
28240.0,763.0,233.0,54.0,0,12159,9808,3189,2056,2013,43,6619,5018,4909,109,9808,45754,0.4218,39.3,11997,28224,24892,115,158,70,378,2611,"Union County, Mississippi",28,145,28145
21793.0,586.0,252.0,6.0,2,8823,7834,2269,1495,1481,14,5565,4182,3913,269,7834,39246,0.4395,38.9,9893,21918,19028,99,97,172,111,2411,"Tippah County, Mississippi",28,139,28139
74256.0,5221.0,2222.0,384.0,102,32128,28086,7235,4182,4053,129,20851,15124,12938,2186,28086,39840,0.4955,38.6,32989,74587,63057,363,765,96,653,9653,"Forrest County, Mississippi",28,035,28035
53101.0,3572.0,3728.0,222.0,183,24559,18721,4315,2796,2662,134,14406,10380,8449,1931,18721,50272,0.5212,35.5,25653,53081,46925,713,855,41,375,4172,"Lafayette County, Mississippi",28,071,28071
58389.0,1291.0,1602.0,129.0,3,25200,22436,6523,3567,3490,77,15913,11932,11164,768,22436,50441,0.4691,38.8,27314,57041,49063,755,365,53,152,6653,"Lowndes County, Mississippi",28,087,28087
8767.0,505.0,44.0,11.0,7,2403,3170,1268,844,755,89,1902,1110,1088,22,3170,27313,0.4907,40.4,5182,7717,6688,0,0,0,0,1029,"Wilkinson County, Mississippi",28,157,28157
11275.0,304.0,53.0,0.0,48,4264,4713,1721,1152,1098,54,2992,2008,1905,103,4713,32116,0.5073,40.1,5973,11230,9567,71,0,0,0,1592,"Jefferson Davis County, Mississippi",28,065,28065
28171.0,527.0,298.0,121.0,151,10973,10180,3196,1804,1759,45,6984,5514,5256,258,10180,34943,0.534,39.6,11716,28071,22878,128,260,44,1610,3151,"Scott County, Mississippi",28,123,28123
28185.0,594.0,1359.0,318.0,0,8648,8542,2695,1369,1344,25,5847,4122,3859,263,8542,33279,0.5346,37.9,10107,23722,20538,55,82,0,55,2992,"Yazoo County, Mississippi",28,163,28163
31461.0,933.0,315.0,17.0,0,10529,12111,3454,2042,1913,129,8657,6202,5806,396,12111,29854,0.5283,39.0,14357,31211,26384,131,222,40,239,4195,"Bolivar County, Mississippi",28,011,28011
39069.0,846.0,764.0,4.0,47,13771,14404,4469,2705,2646,59,9935,6111,5882,229,14404,31784,0.5209,39.6,18519,38870,33264,103,152,0,8,5343,"Pike County, Mississippi",28,113,28113
18065.0,640.0,231.0,23.0,20,7791,6334,1967,1304,1290,14,4367,3373,3270,103,6334,45483,0.4771,39.2,7466,17626,15349,92,14,0,5,2166,"Stone County, Mississippi",28,131,28131
9923.0,513.0,114.0,0.0,0,3223,3611,1367,708,691,17,2244,1603,1510,93,3611,31103,0.4665,39.5,4766,9478,8346,0,7,0,0,1125,"Kemper County, Mississippi",28,069,28069
25805.0,1462.0,192.0,4.0,51,8067,8322,2555,1495,1406,89,5767,4244,3886,358,8322,30838,0.5064,38.4,9668,22128,18850,80,12,0,64,3122,"Sunflower County, Mississippi",28,133,28133
30827.0,203.0,242.0,981.0,100,10169,11237,4210,2556,2435,121,7027,4472,4215,257,11237,29936,0.5216,38.1,14692,28724,24217,159,10,212,5,4121,"Adams County, Mississippi",28,001,28001
176790.0,3169.0,7810.0,437.0,146,88169,62890,16070,10566,10067,499,46820,38351,35722,2629,62890,67038,0.4054,40.2,67168,177891,159083,2547,1965,462,1571,12263,"DeSoto County, Mississippi",28,033,28033
558536.0,17286.0,10820.0,2700.0,28256,272927,207257,64071,39109,37407,1702,143186,109370,101638,7732,207257,74477,0.4837,38.1,224417,556900,479416,30978,19887,2456,5246,18917,"Delaware County, Pennsylvania",42,045,42045
73531.0,1815.0,783.0,61.0,29,31529,29644,10966,6482,6208,274,18678,14802,13733,1069,29644,49089,0.424,39.9,38459,69415,64247,315,166,34,40,4613,"Somerset County, Pennsylvania",42,111,42111
12035.0,577.0,263.0,18.0,3,4968,5044,1657,1017,958,59,3387,2839,2510,329,5044,43636,0.4537,37.8,5978,11938,10549,68,27,55,0,1239,"Madison County, Missouri",29,123,29123
20270.0,557.0,715.0,38.0,23,8607,8207,2636,1574,1454,120,5571,4177,3886,291,8207,43276,0.4479,40.1,9580,20145,17061,88,84,35,20,2857,"Vernon County, Missouri",29,217,29217
22161.0,2172.0,1119.0,145.0,7,10922,8395,2164,1319,1278,41,6231,4662,3564,1098,8395,44232,0.4518,37.0,9766,21562,19193,101,275,46,105,1842,"Nodaway County, Missouri",29,147,29147
7394.0,242.0,31.0,9.0,0,3059,2686,1092,658,643,15,1594,1235,1176,59,2686,46738,0.4398,38.4,4143,7255,6670,12,5,11,8,549,"Chariton County, Missouri",29,041,29041
13044.0,601.0,51.0,0.0,33,4243,5426,2171,1295,1211,84,3255,2392,2054,338,5426,34316,0.4511,40.7,8116,13081,11210,32,14,15,11,1799,"Wayne County, Missouri",29,223,29223
38246.0,2193.0,748.0,100.0,33,16574,15230,4811,2907,2822,85,10419,8116,7537,579,15230,44139,0.4863,38.6,17259,38088,33598,191,117,9,152,4021,"Scott County, Missouri",29,201,29201
11707.0,357.0,329.0,9.0,4,5113,4895,1676,964,947,17,3219,2612,2244,368,4895,44125,0.4761,39.1,5599,11675,10364,6,19,0,57,1229,"Barton County, Missouri",29,011,29011
13833.0,587.0,353.0,14.0,20,5159,5842,2110,1442,1348,94,3732,2728,2497,231,5842,39365,0.4477,38.0,7243,13869,11504,105,89,0,0,2171,"Cedar County, Missouri",29,039,29039
14540.0,917.0,60.0,3.0,0,6922,6076,2200,1419,1362,57,3876,3046,2825,221,6076,54885,0.4253,39.2,8178,14466,13349,117,14,9,0,977,"Gasconade County, Missouri",29,073,29073
15027.0,348.0,53.0,26.0,28,6301,5845,2171,1207,1158,49,3674,2641,2458,183,5845,42746,0.3976,38.9,7671,14943,13201,47,97,0,5,1593,"Macon County, Missouri",29,121,29121
10492.0,361.0,357.0,6.0,35,3963,4249,1736,1073,992,81,2513,1992,1821,171,4249,33601,0.4471,40.1,5481,10527,8643,66,22,0,4,1792,"Oregon County, Missouri",29,149,29149
17729.0,1375.0,211.0,3.0,0,8746,7121,2330,1659,1545,114,4791,3791,3618,173,7121,60129,0.4004,38.8,8735,17621,16644,100,17,0,50,810,"Ste. Genevieve County, Missouri",29,186,29186
13176.0,406.0,430.0,29.0,9,4832,5137,2098,1407,1368,39,3039,2427,2324,103,5137,37425,0.4621,38.3,6515,13189,11101,42,0,27,31,1988,"Douglas County, Missouri",29,067,29067
21526.0,1456.0,217.0,52.0,14,8988,9328,3348,2024,1854,170,5980,4459,4058,401,9328,45795,0.4699,39.1,10960,21427,18752,169,51,2,138,2315,"Henry County, Missouri",29,083,29083
37634.0,1469.0,1492.0,72.0,1,16620,14787,4803,2816,2653,163,9984,8142,7675,467,14787,44742,0.434,39.6,16694,37642,31731,153,677,63,274,4744,"Lawrence County, Missouri",29,109,29109
51704.0,1580.0,12065.0,1393.0,120,28437,15154,2744,1772,1689,83,12410,9467,8649,818,15154,53492,0.3882,42.9,19094,39306,33192,1126,812,8,63,4105,"Pulaski County, Missouri",29,169,29169
25334.0,1012.0,622.0,35.0,32,8751,9728,3441,2293,2172,121,6287,4705,4345,360,9728,35067,0.4769,39.2,11721,24250,20033,260,46,33,0,3878,"Texas County, Missouri",29,215,29215
44318.0,3286.0,481.0,14.0,21,19978,15973,4948,3186,3006,180,11025,8377,7819,558,15973,56938,0.4022,38.6,18919,42177,37687,434,210,46,35,3765,"Callaway County, Missouri",29,027,29027
17438.0,1306.0,332.0,14.0,11,7613,6397,2062,1130,1084,46,4335,3307,3094,213,6397,52735,0.4057,39.1,7509,16080,14336,76,73,6,7,1582,"Cooper County, Missouri",29,053,29053
6487.0,171.0,52.0,2.0,29,2988,2555,824,478,467,11,1731,1299,1240,59,2555,47790,0.4356,39.1,3190,6473,5722,17,51,3,1,679,"Gentry County, Missouri",29,075,29075
53684.0,2288.0,1143.0,106.0,47,23386,22321,8481,5262,5129,133,13840,10299,9715,584,22321,48495,0.4523,38.9,25961,53184,47583,350,304,29,51,4867,"Washington County, Virginia",51,191,51191
23518.0,857.0,222.0,31.0,30,10731,9286,3517,2279,2111,168,5769,4759,4267,492,9286,51792,0.4031,38.9,11747,23556,20372,200,116,21,42,2805,"Page County, Virginia",51,139,51139
155488.0,8382.0,10307.0,3375.0,19643,98619,70598,13292,6633,6157,476,57306,34817,28345,6472,70598,100939,0.4472,41.2,76357,153892,106770,15445,14828,1818,10672,4359,"Alexandria city, Virginia",51,510,51510
133773.0,8099.0,6456.0,523.0,1418,65421,54050,14501,8420,7854,566,39549,28013,24407,3606,54050,56287,0.4362,38.6,60140,129082,113420,3452,1739,330,485,9656,"Hampton city, Virginia",51,650,51650
230570.0,10091.0,14881.0,5155.0,40639,148487,107032,18373,9831,9137,694,88659,55282,40129,15153,107032,120071,0.4409,41.9,114779,228804,171331,24729,19222,1604,8223,3695,"Arlington County, Virginia",51,013,51013
21610.0,456.0,563.0,30.0,58,6252,8569,3204,2051,1921,130,5365,4084,3852,232,8569,31956,0.4675,38.9,11579,20910,18113,154,43,25,0,2575,"Buchanan County, Virginia",51,027,51027
145139.0,7475.0,6627.0,1108.0,2855,74495,47075,10185,7689,7416,273,36890,32176,30530,1646,47075,111108,0.3674,39.4,49292,141163,119952,6967,3821,1078,2147,7198,"Stafford County, Virginia",51,179,51179
223805.0,18591.0,7058.0,1837.0,6512,114751,90301,21347,10251,9218,1033,68954,40851,30763,10088,90301,47250,0.5448,37.7,100458,223952,188614,4441,4025,419,7004,19449,"Richmond city, Virginia",51,760,51760
10893.0,353.0,186.0,4.0,0,4998,4555,1648,1067,1040,27,2907,2120,1934,186,4555,51954,0.4236,39.7,5855,10894,9831,95,33,17,26,892,"Essex County, Virginia",51,057,51057
40873.0,898.0,863.0,5.0,14,14600,16531,6328,3809,3716,93,10203,7835,7390,445,16531,42099,0.4565,38.1,20754,40320,36058,108,160,13,33,3948,"Tazewell County, Virginia",51,185,51185
16871.0,1718.0,584.0,146.0,670,9221,4641,886,630,563,67,3755,2998,2714,284,4641,88046,0.3784,38.9,4879,16957,9735,2545,1782,401,1407,1087,"Manassas Park city, Virginia",51,685,51685
11262.0,1278.0,131.0,19.0,50,4077,3794,1402,895,846,49,2392,1825,1664,161,3794,49487,0.41,39.4,4797,9086,8045,69,66,21,45,840,"Sussex County, Virginia",51,183,51183
40520.0,2895.0,750.0,271.0,730,21464,12898,2861,1874,1843,31,10037,8180,7626,554,12898,81493,0.4018,39.1,13693,41082,27849,3553,3415,783,2991,2491,"Manassas city, Virginia",51,683,51683
25119.0,2005.0,551.0,45.0,50,12197,9912,3348,1875,1760,115,6564,4756,4392,364,9912,57165,0.4514,37.8,10840,24411,22171,284,397,9,131,1419,"Salem city, Virginia",51,775,51775
11954.0,384.0,151.0,0.0,8,4896,4661,1877,1017,981,36,2784,2099,1953,146,4661,40573,0.4677,39.5,6345,11908,10295,68,13,0,4,1528,"Charlotte County, Virginia",51,037,51037
11477.0,1745.0,146.0,0.0,18,3867,3647,1347,791,757,34,2300,1700,1610,90,3647,50300,0.4139,38.7,4190,8244,7339,24,12,0,57,812,"Greensville County, Virginia",51,081,51081
276759.0,12879.0,10723.0,2519.0,2631,129904,109983,32896,21137,19756,1381,77087,60323,53210,7113,109983,72003,0.4136,38.3,116556,273396,240979,12689,6488,557,2508,10175,"Thurston County, Washington",53,067,53067
3954.0,213.0,67.0,0.0,4,1701,1795,802,427,405,22,993,765,678,87,1795,53423,0.5152,37.7,2168,3944,3562,144,48,31,73,86,"Columbia County, Washington",53,013,53013
,,,,0,4733,6510,2539,1836,1769,67,3971,3185,3047,138,6510,17379,0.4556,33.5,8233,18447,17745,30,36,28,10,598,"Guayanilla Municipio, Puerto Rico",72,059,72059
,,,,30,6324,7061,3343,2348,2228,120,3718,2667,2595,72,7061,17319,0.4856,33.9,10842,22443,21028,33,37,0,0,1345,"Sabana Grande Municipio, Puerto Rico",72,121,72121
,,,,99,4842,6255,3021,1725,1641,84,3234,2490,2387,103,6255,19030,0.5166,34.0,7649,15898,15183,82,11,0,19,603,"Hormigueros Municipio, Puerto Rico",72,067,72067
,,,,9,6001,9593,4138,2619,2460,159,5455,4437,4233,204,9593,15399,0.5233,34.0,13240,28655,26637,26,33,0,0,1959,"Utuado Municipio, Puerto Rico",72,141,72141
,,,,16,3386,4271,1408,1041,1041,0,2863,2358,2273,85,4271,20442,0.4362,32.3,4963,11684,11275,0,0,0,0,409,"Florida Municipio, Puerto Rico",72,054,72054
,,,,27,9089,13374,4283,3003,2946,57,9091,6833,6623,210,13374,15037,0.5831,34.0,16165,35981,34084,141,67,19,61,1609,"Moca Municipio, Puerto Rico",72,099,72099
,,,,12,7674,10036,3815,2455,2369,86,6221,4858,4499,359,10036,18189,0.4753,34.4,13301,27995,26326,72,62,0,0,1535,"Salinas Municipio, Puerto Rico",72,123,72123
13411.0,648.0,179.0,23.0,17,4462,5026,1631,984,942,42,3395,2896,2695,201,5026,35357,0.4894,39.2,5724,11858,10020,17,66,0,40,1715,"Mississippi County, Missouri",29,133,29133
9128.0,424.0,155.0,9.0,8,2975,3958,1784,1071,1014,57,2174,1503,1376,127,3958,31947,0.4531,38.4,5707,9151,7720,61,7,0,11,1352,"Ozark County, Missouri",29,153,29153
12109.0,569.0,59.0,0.0,36,5089,4593,1648,1014,989,25,2945,2252,2138,114,4593,44158,0.4082,38.3,5885,12144,10669,55,16,0,0,1404,"Bollinger County, Missouri",29,017,29017
181751.0,7474.0,5495.0,462.0,190,91006,67089,19535,12971,12563,408,47554,38165,35932,2233,67089,67204,0.4431,39.6,71863,181810,160237,3369,2751,745,1759,12949,"Sumner County, Tennessee",47,165,47165
10032.0,461.0,234.0,23.0,0,4543,3189,979,591,578,13,2210,1620,1505,115,3189,56321,0.3856,38.9,3610,9335,8070,22,9,0,52,1182,"Trousdale County, Tennessee",47,169,47169
7568.0,144.0,89.0,0.0,2,2649,3039,1185,767,703,64,1854,1404,1299,105,3039,32167,0.4723,35.8,4340,7557,6647,49,13,16,98,734,"Clay County, Tennessee",47,027,47027
14489.0,769.0,65.0,60.0,1,6941,5959,2013,1056,1032,24,3946,3243,2910,333,5959,61456,0.392,39.3,6487,14359,11976,53,34,0,44,2252,"Moultrie County, Illinois",17,139,17139
15479.0,506.0,138.0,29.0,11,6725,6309,2155,1206,1176,30,4154,3116,2897,219,6309,47492,0.4368,39.3,7985,15234,14411,40,43,6,3,731,"Pike County, Illinois",17,149,17149
4173.0,135.0,123.0,0.0,15,1102,1694,754,434,434,0,940,546,533,13,1694,38056,0.4328,36.5,2806,4049,3844,29,16,0,0,160,"Pope County, Illinois",17,151,17151
259038.0,5581.0,8643.0,938.0,3782,122774,104105,28731,16548,15922,626,75374,53781,49245,4536,104105,55179,0.4688,38.2,120236,256193,234015,3670,2672,169,1551,14116,"St. Clair County, Illinois",17,163,17163
21527.0,740.0,181.0,13.0,38,10301,9189,3359,1987,1944,43,5830,4680,4241,439,9189,52953,0.394,39.2,10616,21554,20629,38,57,0,0,830,"Shelby County, Illinois",17,173,17173
207739.0,14373.0,6118.0,3528.0,5795,101466,82369,17710,10272,9612,660,64659,42021,32723,9298,82369,52797,0.5061,35.6,92699,208115,176612,7619,15622,517,1751,5994,"Champaign County, Illinois",17,019,17019
4800.0,100.0,33.0,2.0,6,1993,1664,639,388,383,5,1025,806,771,35,1664,63009,0.4125,36.6,2875,4750,4651,28,6,0,2,63,"Calhoun County, Illinois",17,013,17013
13162.0,789.0,184.0,21.0,11,6233,5771,1674,847,815,32,4097,2938,2732,206,5771,52092,0.4239,38.6,6360,12872,12124,83,26,7,14,618,"Ford County, Illinois",17,053,17053
525088.0,21933.0,6410.0,1774.0,6430,262617,179637,48426,31129,29691,1438,131211,109203,102068,7135,179637,79394,0.4431,38.8,187967,528072,417506,37071,29470,4422,21722,17881,"Kane County, Illinois",17,089,17089
124310.0,8205.0,924.0,904.0,1594,64494,40721,8687,5790,5741,49,32034,27869,26320,1549,40721,96563,0.3599,39.6,42029,125714,109478,5866,4082,558,1415,4315,"Kendall County, Illinois",17,093,17093
6520.0,987.0,20.0,11.0,11,2386,2055,613,295,295,0,1442,1170,1007,163,2055,61655,0.3958,41.3,2449,4753,4340,91,21,0,0,301,"Brown County, Illinois",17,009,17009
37229.0,994.0,405.0,27.0,28,15848,15946,5132,2786,2642,144,10814,8097,7338,759,15946,47519,0.4314,39.1,18274,37041,34291,202,152,0,83,2313,"Marion County, Illinois",17,121,17121
13535.0,508.0,115.0,2.0,0,6229,5977,2137,1159,1131,28,3840,3112,2662,450,5977,48417,0.4294,39.4,7055,13415,12754,93,7,0,6,555,"Mason County, Illinois",17,125,17125
27555.0,1045.0,335.0,49.0,15,12705,11741,4147,2317,2188,129,7594,6001,5469,532,11741,52700,0.4164,38.8,13493,27382,25112,331,348,10,180,1401,"Iroquois County, Illinois",17,075,17075
13164.0,874.0,99.0,9.0,68,5944,5696,1821,1112,1010,102,3875,2961,2808,153,5696,48500,0.4286,40.1,6441,13119,12225,46,11,0,1,836,"Clay County, Illinois",17,025,17025
5034.0,183.0,25.0,15.0,4,2076,2293,920,511,498,13,1373,1053,1008,45,2293,44076,0.5553,40.5,2741,5064,4891,17,6,0,0,150,"Gallatin County, Illinois",17,059,17059
33776.0,536.0,539.0,42.0,54,17859,13586,4081,2698,2582,116,9505,7863,7523,340,13586,85747,0.4253,38.7,14181,33894,32377,463,190,0,11,853,"Monroe County, Illinois",17,133,17133
16713.0,437.0,80.0,0.0,9,6852,6654,2290,1371,1357,14,4364,3488,3202,286,6654,50625,0.437,38.6,7994,16809,15540,198,94,18,157,802,"Union County, Illinois",17,181,17181
281321.0,7070.0,3760.0,1103.0,1449,130323,114779,34377,20388,19423,965,80402,59802,54476,5326,114779,54489,0.4489,38.5,125707,281711,245994,10882,8306,735,3850,11944,"Winnebago County, Illinois",17,201,17201
5443.0,125.0,47.0,8.0,9,1783,2095,936,449,408,41,1159,934,881,53,2095,34640,0.4972,36.4,3164,5505,5169,12,26,0,8,290,"Pulaski County, Illinois",17,153,17153
6841.0,484.0,13.0,51.0,0,2882,2775,1041,635,622,13,1734,1292,1059,233,2775,52357,0.3828,39.6,3453,6882,6016,17,202,0,0,647,"Schuyler County, Illinois",17,169,17169
17165.0,560.0,352.0,4.0,7,8084,7542,2575,1402,1395,7,4967,3983,3743,240,7542,53647,0.4004,38.9,8839,17119,16158,88,28,9,3,833,"Edgar County, Illinois",17,045,17045
53089.0,2874.0,731.0,142.0,63,25423,18571,5624,3558,3384,174,12947,11143,10514,629,18571,69272,0.4412,39.0,20060,53129,45559,1900,2483,192,894,2101,"Boone County, Illinois",17,007,17007
32775.0,847.0,317.0,32.0,86,15720,13698,4929,2977,2869,108,8769,6907,6415,492,13698,57436,0.4206,38.9,15682,32755,30325,434,475,72,237,1212,"Bureau County, Illinois",17,011,17011
50804.0,4103.0,897.0,218.0,165,24502,20926,6069,3454,3295,159,14857,10588,8706,1882,20926,46202,0.5022,36.7,23495,50657,46545,399,606,3,110,2994,"Coles County, Illinois",17,029,17029
18758.0,1393.0,357.0,1.0,24,7565,7666,2542,1356,1308,48,5124,3989,3666,323,7666,49779,0.4608,38.8,8689,16659,15478,128,33,3,14,1003,"Crawford County, Illinois",17,033,17033
5665.0,241.0,61.0,0.0,0,2827,2413,871,588,581,7,1542,1165,1048,117,2413,63638,0.3998,40.5,3147,5714,5420,114,33,2,0,145,"Putnam County, Illinois",17,155,17155
15739.0,545.0,49.0,0.0,0,7847,6694,2105,1177,1167,10,4589,3344,3178,166,6694,55587,0.4206,38.3,7569,15649,14804,66,129,0,40,610,"De Witt County, Illinois",17,039,17039
34058.0,2293.0,363.0,75.0,56,15229,13788,4257,2283,2207,76,9531,7028,6172,856,13788,58194,0.436,39.2,15083,31305,29505,425,243,0,55,1077,"Lee County, Illinois",17,103,17103
44958.0,1473.0,555.0,13.0,49,20225,18875,6200,3710,3609,101,12675,10118,9246,872,18875,55159,0.4203,38.1,21738,44981,42632,226,97,17,44,1965,"Macoupin County, Illinois",17,117,17117
15648.0,416.0,156.0,74.0,22,6987,6452,2155,1256,1210,46,4297,3165,2863,302,6452,48894,0.4302,37.9,7518,15571,14666,65,166,0,8,666,"Richland County, Illinois",17,159,17159
13915.0,479.0,161.0,3.0,53,6912,6020,1880,1119,1059,60,4140,3247,3001,246,6020,61763,0.3973,41.2,6651,13857,13250,76,45,0,0,486,"Washington County, Illinois",17,189,17189
583442.0,18069.0,21464.0,4557.0,18530,303481,219053,53143,32941,30999,1942,165910,132075,115613,16462,219053,82215,0.4257,38.4,229077,585945,461540,44826,45127,2511,11756,20185,"Washington County, Oregon",41,067,41067
38764.0,1668.0,1678.0,67.0,199,17728,15800,5872,3634,3274,360,9928,7304,6349,955,15800,54886,0.4121,38.2,22447,38389,33868,768,628,95,314,2716,"Clatsop County, Oregon",41,007,41007
4522.0,224.0,45.0,6.0,7,1982,2184,887,456,443,13,1297,858,752,106,2184,41165,0.4071,38.3,4429,4572,4390,32,6,13,0,131,"Cameron County, Pennsylvania",42,023,42023
620781.0,14173.0,11466.0,2168.0,10799,325917,238830,79052,51508,49311,2197,159778,129055,119482,9573,238830,89139,0.4499,39.1,250552,621003,542700,37432,15882,1541,5920,17528,"Bucks County, Pennsylvania",42,017,42017
360990.0,10472.0,8527.0,2337.0,3630,175604,138714,41130,25754,24297,1457,97584,76881,69637,7244,138714,63897,0.457,38.5,146145,359963,301086,21977,13570,2048,5123,16159,"Lehigh County, Pennsylvania",42,077,42077
38337.0,2155.0,403.0,25.0,67,17018,16021,5210,3052,2906,146,10811,8207,7093,1114,16021,46680,0.4373,38.2,20542,38317,35106,208,112,16,90,2785,"Clarion County, Pennsylvania",42,031,42031
36424.0,1165.0,562.0,63.0,12,14029,14230,4881,2907,2743,164,9349,7283,6689,594,14230,54776,0.4453,39.0,16745,34341,32507,185,86,0,4,1559,"Greene County, Pennsylvania",42,059,42059
314826.0,6219.0,6952.0,1387.0,1566,148959,128660,44158,24962,23614,1348,84502,63287,57438,5849,128660,53473,0.449,38.4,150090,309905,277025,8869,8446,714,3016,11835,"Luzerne County, Pennsylvania",42,079,42079
65139.0,3309.0,804.0,56.0,118,30084,26372,8780,5213,4967,246,17592,12967,11239,1728,26372,50550,0.4544,37.6,30175,64957,60825,794,466,68,41,2763,"Columbia County, Pennsylvania",42,037,42037
43337.0,1219.0,467.0,60.0,140,19359,18427,6304,3724,3641,83,12123,9399,8510,889,18427,47603,0.4223,39.4,22686,43302,39621,182,75,3,0,3421,"Jefferson County, Pennsylvania",42,065,42065
45588.0,1423.0,410.0,24.0,50,22289,18231,5810,3696,3539,157,12421,10071,9345,726,18231,63718,0.4023,39.2,20853,45539,40989,244,147,27,66,4066,"Perry County, Pennsylvania",42,099,42099
6097.0,359.0,79.0,7.0,4,2647,2723,1134,660,625,35,1589,1098,965,133,2723,47407,0.4362,40.2,6370,5950,5448,40,6,0,45,411,"Sullivan County, Pennsylvania",42,113,42113
162250.0,5022.0,3172.0,348.0,1028,85743,69422,22249,12317,11762,555,47173,35742,31637,4105,69422,73521,0.4404,38.7,74373,162760,147981,6261,3056,174,529,4759,"Kent County, Rhode Island",44,003,44003
125208.0,2788.0,4437.0,345.0,773,63523,49102,17213,11261,10547,714,31889,24928,22283,2645,49102,85531,0.4398,36.8,64016,125053,116123,3706,1936,124,187,2977,"Washington County, Rhode Island",44,009,44009
37799.0,1207.0,516.0,61.0,13,16616,14810,5169,3143,2907,236,9641,7234,6798,436,14810,44226,0.4696,38.5,18288,37724,33247,424,773,9,673,2598,"Newberry County, South Carolina",45,071,45071
33660.0,827.0,521.0,92.0,57,11683,13161,5515,3559,3383,176,7646,5774,5434,340,13161,40900,0.4993,38.8,17840,32522,28526,247,211,0,261,3277,"Clarendon County, South Carolina",45,027,45027
105226.0,1783.0,3356.0,812.0,96,44970,41776,12325,7772,7448,324,29451,22108,20686,1422,41776,45661,0.4435,39.5,48120,102309,88582,1080,1010,495,471,10671,"Sumter County, South Carolina",45,085,45085
21138.0,952.0,552.0,36.0,24,7822,8360,2670,1559,1528,31,5690,4068,3732,336,8360,35803,0.4741,39.3,10551,21064,18429,72,97,33,112,2321,"Barnwell County, South Carolina",45,011,45011
66133.0,2268.0,680.0,52.0,49,26414,26484,8969,5149,4965,184,17515,13095,12130,965,26484,38448,0.4765,38.8,30798,66310,58663,590,259,54,193,6551,"Darlington County, South Carolina",45,031,45031
262928.0,7316.0,13442.0,1017.0,606,131129,101211,26255,17544,16883,661,74956,58091,53600,4491,101211,65361,0.4486,39.6,107404,264144,231359,6293,5200,731,1987,18574,"York County, South Carolina",45,091,45091
56301.0,1237.0,838.0,62.0,36,22732,20699,5987,3611,3489,122,14712,8641,8103,538,20699,36883,0.478,38.9,24568,56581,49896,398,343,85,533,5326,"Cherokee County, South Carolina",45,021,45021
28406.0,1869.0,743.0,11.0,17,12158,10269,3523,2468,2304,164,6746,5210,4994,216,10269,45601,0.4589,39.6,11865,28115,22742,384,598,283,1334,2774,"Jasper County, South Carolina",45,053,45053
17137.0,555.0,106.0,0.0,21,5894,6423,2272,1456,1412,44,4151,2649,2559,90,6423,32371,0.5068,39.4,7773,15902,14024,35,81,106,23,1633,"Lee County, South Carolina",45,061,45061
24317.0,1118.0,329.0,12.0,44,9791,9660,3645,2081,2042,39,6015,4531,4206,325,9660,38741,0.479,38.1,12191,24397,21415,179,87,39,122,2555,"Abbeville County, South Carolina",45,001,45001
3761.0,145.0,34.0,1.0,7,1665,1397,409,303,268,35,988,767,700,67,1397,53862,0.3886,40.4,1732,3827,3184,27,3,0,0,613,"Lyman County, South Dakota",46,085,46085
4219.0,143.0,84.0,7.0,0,2309,1798,616,361,355,6,1182,945,888,57,1798,65437,0.3788,43.4,2218,4260,3918,0,19,0,43,280,"Deuel County, South Dakota",46,039,46039
27539.0,1088.0,201.0,96.0,18,10994,10085,3304,2300,2197,103,6781,5634,5193,441,10085,49633,0.4442,40.1,11008,27679,21056,1666,2578,77,738,1564,"Glenn County, California",06,021,06021
223642.0,11754.0,1985.0,464.0,1105,93125,85320,28657,17901,16511,1390,56663,43834,34936,8898,85320,52537,0.4944,36.2,96505,223229,195066,8506,5923,458,1464,11812,"Butte County, California",06,007,06007
148723.0,9550.0,2918.0,495.0,129,56799,43452,10532,7516,7193,323,32920,28275,26238,2037,43452,57848,0.4272,40.1,46181,133994,102087,9944,11898,403,4218,5444,"Kings County, California",06,031,06031
18529.0,1021.0,357.0,90.0,67,7485,8450,3573,2313,2081,232,4877,3432,2959,473,8450,55359,0.4667,38.1,15830,18504,17196,441,298,0,23,546,"Plumas County, California",06,063,06063
279856.0,15687.0,5175.0,815.0,1752,130710,105981,37753,24790,23031,1759,68228,53652,44137,9515,105981,73518,0.4496,36.1,122005,275626,236211,13407,9335,728,4253,11692,"San Luis Obispo County, California",06,079,06079
970564.0,21415.0,7419.0,4358.0,4408,395689,307906,83694,54248,51176,3072,224212,185418,171241,14177,307906,53969,0.4746,38.1,331142,973266,723887,79027,89188,5354,33576,42234,"Fresno County, California",06,019,06019
875538.0,26921.0,9653.0,4176.0,2760,337438,270282,67788,44881,42602,2279,202494,169368,157824,11544,270282,53350,0.4668,38.9,298117,859905,649524,57221,84906,4500,25778,37976,"Kern County, California",06,029,06029
3133653.0,74088.0,34851.0,27695.0,30245,1562046,1037492,309022,213902,201191,12711,728470,604755,542820,61935,1037492,90234,0.4685,38.1,1100449,3151089,2101829,493433,316796,25467,114478,99086,"Orange County, California",06,059,06059
837350.0,19258.0,8390.0,4423.0,4582,407902,271040,86618,59939,56686,3253,184422,152282,139721,12561,271040,88131,0.4455,38.1,288896,840257,623147,86261,56928,5340,35382,33199,"Ventura County, California",06,111,06111
45301.0,2231.0,263.0,113.0,164,16860,16942,8021,5317,4912,405,8921,7309,6779,530,16942,63158,0.4414,38.3,27995,45112,41001,1288,850,0,21,1952,"Calaveras County, California",06,009,06009
94782.0,4602.0,854.0,668.0,285,38584,32636,10174,6883,6600,283,22462,18680,17237,1443,32636,59050,0.453,39.0,34395,94654,69398,10139,7527,731,2894,3965,"Sutter County, California",06,101,06101
759450.0,29840.0,10581.0,9250.0,44722,406128,263543,81720,55600,52363,3237,181823,149186,132265,16921,263543,122641,0.4849,39.0,277773,763665,483876,149048,98853,4228,14241,13419,"San Mateo County, California",06,081,06081
53741.0,4203.0,467.0,181.0,111,20071,22502,9685,5981,5472,509,12817,9343,8285,1058,22502,60108,0.4832,36.8,31553,50971,45857,1692,643,10,111,2658,"Tuolumne County, California",06,109,06109
733080.0,27399.0,6299.0,3832.0,5055,303147,228567,64487,44231,42058,2173,164080,137862,128471,9391,228567,64432,0.4529,38.5,243260,732477,535955,81084,68319,4160,18353,24606,"San Joaquin County, California",06,077,06077
38114.0,2584.0,478.0,24.0,15,13281,14594,6905,4620,4350,270,7689,5957,5522,435,14594,62772,0.449,38.5,18379,34742,31388,1220,512,27,184,1411,"Amador County, California",06,005,06005
4243.0,145.0,78.0,20.0,0,1903,1689,458,253,241,12,1231,906,874,32,1689,51155,0.3953,43.6,1939,4210,3258,104,248,52,199,349,"Phillips County, Colorado",08,095,08095
13163.0,582.0,590.0,61.0,6,5893,5858,2350,1644,1535,109,3508,2641,2304,337,5858,52221,0.4511,38.5,9373,13146,11262,327,156,66,113,1222,"Archuleta County, Colorado",08,007,08007
696798.0,42087.0,34506.0,5207.0,25824,394894,301501,61480,31717,29167,2550,240021,154580,116903,37677,301501,68592,0.4909,40.0,321717,699351,558698,37030,38393,3627,26308,35295,"Denver County, Colorado",08,031,08031
1466.0,69.0,37.0,0.0,0,679,638,243,133,126,7,395,285,260,25,638,41731,0.4434,42.7,795,1462,1365,5,0,0,4,88,"Kiowa County, Colorado",08,061,08061
6664.0,325.0,262.0,0.0,5,2459,3225,1527,889,816,73,1698,1131,1047,84,3225,38137,0.4341,38.5,5265,6537,5787,60,63,0,28,599,"Huerfano County, Colorado",08,055,08055
3532.0,78.0,100.0,13.0,0,1598,1662,649,377,367,10,1013,759,709,50,1662,35878,0.4562,40.9,2258,3461,3165,28,32,3,51,182,"Baca County, Colorado",08,009,08009
5964.0,492.0,337.0,0.0,25,3767,2802,812,514,514,0,1990,1323,1126,197,2802,76429,0.4468,40.2,3799,5960,5445,126,49,0,101,239,"Gilpin County, Colorado",08,047,08047
7358.0,323.0,286.0,22.0,28,3350,3004,991,621,605,16,2013,1437,1400,37,3004,49349,0.4595,41.1,3568,6951,6036,113,168,2,208,424,"Kit Carson County, Colorado",08,063,08063
16683.0,1147.0,814.0,106.0,515,9470,6616,1548,871,781,90,5068,3519,2600,919,6616,56577,0.4321,37.2,11955,16755,14751,302,111,0,224,1367,"Gunnison County, Colorado",08,051,08051
812.0,25.0,51.0,6.0,0,405,367,150,121,111,10,217,161,152,9,367,62188,0.3755,37.3,1335,824,738,11,0,0,0,75,"Mineral County, Colorado",08,079,08079
4765.0,122.0,177.0,6.0,0,2266,2163,846,666,603,63,1317,943,766,177,2163,66417,0.4666,39.6,3185,4796,4245,35,37,4,5,470,"Ouray County, Colorado",08,091,08091
2260.0,107.0,108.0,6.0,0,923,967,359,207,181,26,608,395,383,12,967,43150,0.5065,39.7,1191,2290,2026,20,38,0,10,196,"Sedgwick County, Colorado",08,115,08115
301440.0,17814.0,8318.0,1059.0,808,150170,104671,25394,16945,16232,713,79277,66165,60280,5885,104671,74150,0.4157,39.6,109170,302837,259715,8226,10962,1274,6058,16602,"Weld County, Colorado",08,123,08123
4776.0,274.0,90.0,0.0,0,1650,2214,1160,896,844,52,1054,686,659,27,2214,53119,0.4154,36.0,4408,4768,3845,127,22,0,0,774,"Custer County, Colorado",08,027,08027
3720.0,73.0,140.0,14.0,0,1338,1746,812,454,397,57,934,676,645,31,1746,30965,0.4988,37.9,2845,3745,3151,128,36,17,164,249,"Costilla County, Colorado",08,023,08023
332877.0,16533.0,13144.0,1693.0,3173,180283,120709,26498,18798,18138,660,94211,80544,75495,5049,120709,119730,0.3993,39.6,124771,334814,301505,13764,10310,366,1190,7679,"Douglas County, Colorado",08,035,08035
7751.0,443.0,400.0,0.0,0,4206,3392,595,345,254,91,2797,2133,1682,451,3392,50565,0.4414,42.1,4894,7700,6374,115,133,20,450,608,"Lake County, Colorado",08,065,08065
55105.0,1418.0,2524.0,107.0,262,28818,21794,6291,3997,3786,211,15503,10966,9293,1673,21794,68685,0.4703,37.6,27825,55146,49329,732,466,74,235,4310,"La Plata County, Colorado",08,067,08067
17805.0,587.0,495.0,421.0,2234,11730,7467,2319,1451,1256,195,5148,3559,2594,965,7467,78935,0.509,38.5,14016,17891,14337,1165,609,27,778,975,"Pitkin County, Colorado",08,097,08097
11236.0,552.0,248.0,5.0,28,4491,4823,1454,912,894,18,3369,2255,2052,203,4823,39123,0.4661,37.2,6806,11148,9755,30,159,21,248,935,"Rio Grande County, Colorado",08,105,08105
5787.0,182.0,59.0,5.0,39,1439,1767,654,382,370,12,1113,843,748,95,1767,30900,0.4527,39.9,2270,3985,3572,20,41,48,42,262,"Bent County, Colorado",08,011,08011
5724.0,411.0,132.0,0.0,15,1933,1301,453,275,258,17,848,682,647,35,1301,42135,0.4013,34.2,1589,4782,4372,23,90,0,0,297,"Crowley County, Colorado",08,025,08025
589.0,32.0,9.0,0.0,0,339,289,106,69,59,10,183,104,74,30,289,54625,0.3974,42.1,751,589,531,6,0,11,0,41,"San Juan County, Colorado",08,111,08111
341167.0,16883.0,15317.0,2032.0,2832,179699,137021,36500,23416,22146,1270,100521,80330,62224,18106,137021,71881,0.4463,37.7,148229,342248,305762,8187,7940,448,2675,17236,"Larimer County, Colorado",08,069,08069
22109.0,1958.0,466.0,109.0,76,10990,8393,2511,1518,1454,64,5882,4060,3590,470,8393,53318,0.4217,40.4,9108,21911,19309,184,394,0,426,1598,"Logan County, Colorado",08,075,08075
7972.0,137.0,510.0,58.0,339,5020,3552,802,471,449,22,2750,1802,1443,359,3552,67038,0.5175,40.4,6886,8033,6635,296,406,67,83,546,"San Miguel County, Colorado",08,113,08113
24333.0,1929.0,1162.0,0.0,5,11738,10248,3826,2726,2591,135,6422,4950,4438,512,10248,66592,0.4099,38.4,13256,24332,21490,517,236,6,42,2041,"Teller County, Colorado",08,119,08119
25518.0,2502.0,275.0,38.0,38,13537,9280,2755,2106,2034,72,6525,5695,5369,326,9280,99199,0.4013,40.5,9614,25626,23743,317,213,17,155,1181,"Elbert County, Colorado",08,039,08039
14124.0,730.0,525.0,32.0,32,5669,6670,2500,1354,1274,80,4170,2919,2532,387,6670,41817,0.4708,38.0,8576,13640,11997,222,259,26,218,918,"Las Animas County, Colorado",08,071,08071
5535.0,146.0,67.0,0.0,0,1470,1518,627,329,317,12,891,665,601,64,1518,47258,0.4737,39.9,1988,3500,3146,14,58,11,45,226,"Lincoln County, Colorado",08,073,08073
30345.0,1144.0,577.0,180.0,824,19271,10641,2513,1764,1648,116,8128,5792,4224,1568,10641,79277,0.405,40.2,31220,30569,23202,857,1435,36,1169,3870,"Summit County, Colorado",08,117,08117
15892.0,1334.0,548.0,35.0,19,6601,6162,1609,991,980,11,4553,3293,2786,507,6162,37515,0.487,36.6,7024,15631,12929,517,285,106,535,1259,"Alamosa County, Colorado",08,003,08003
30386.0,1295.0,701.0,75.0,62,10724,11883,5271,3417,3106,311,6612,4870,4630,240,11883,45269,0.4805,40.1,14827,29342,25821,643,373,105,161,2239,"Delta County, Colorado",08,029,08029
46942.0,1208.0,1666.0,176.0,24,14189,17136,6747,4476,4241,235,10389,7990,7203,787,17136,49409,0.4364,38.0,19805,36229,33232,394,97,18,27,2461,"Fremont County, Colorado",08,043,08043
41288.0,1516.0,1129.0,60.0,61,17302,17140,6690,4106,3999,107,10450,8224,7705,519,17140,50489,0.4518,39.1,19048,41335,34917,1156,896,377,795,3194,"Montrose County, Colorado",08,085,08085
28080.0,1643.0,945.0,64.0,11,13327,10928,3090,1793,1719,74,7838,6471,5946,525,10928,53682,0.4076,41.0,11783,28143,22199,1402,2014,96,902,1530,"Morgan County, Colorado",08,087,08087
6495.0,262.0,67.0,0.0,18,2735,2860,1039,562,533,29,1821,1300,1255,45,2860,38571,0.4521,38.5,4151,6566,5290,192,208,70,191,615,"Saguache County, Colorado",08,109,08109
11834.0,367.0,436.0,12.0,0,5409,4888,1539,804,732,72,3349,2584,2431,153,4888,41929,0.4428,42.1,5982,11879,9973,376,339,31,471,689,"Prowers County, Colorado",08,099,08099
4813.0,652.0,142.0,8.0,0,2241,2087,705,432,401,31,1382,1104,1035,69,2087,50094,0.4305,42.3,2373,4565,4249,41,61,8,24,182,"Washington County, Colorado",08,121,08121
15203.0,539.0,690.0,55.0,181,8436,5884,1617,1022,930,92,4267,3114,2670,444,5884,71198,0.4137,40.2,16780,15243,12722,251,272,113,194,1691,"Grand County, Colorado",08,049,08049
18113.0,866.0,457.0,36.0,8,6854,7722,2624,1458,1364,94,5098,3711,3288,423,7722,38169,0.4568,38.4,8999,18104,15784,241,210,48,416,1405,"Otero County, Colorado",08,089,08089
67261.0,7295.0,3777.0,443.0,1692,37971,27470,6415,4210,4035,175,21055,16106,13896,2210,27470,96416,0.4343,39.4,28374,67545,59179,3370,2071,187,411,2327,"Broomfield County, Colorado",08,014,08014
222059.0,2564.0,9367.0,524.0,387,97681,91697,40414,28126,26773,1353,51283,39422,35913,3509,91697,63162,0.4505,38.7,138183,221482,195292,6735,4641,489,4677,9648,"Sussex County, Delaware",10,005,10005
683716.0,0.0,55650.0,10288.0,129713,373844,284386,62410,31003,28058,2945,221976,127994,95625,32369,284386,86420,0.5269,40.3,315176,682728,571685,40340,45524,1420,7363,16396,"District of Columbia, District of Columbia",11,001,11001
849398.0,15242.0,17288.0,6726.0,16090,422610,330572,101272,60817,57747,3070,229300,166545,148754,17791,330572,69905,0.4691,37.7,367053,847650,714834,53316,37108,2922,14896,24574,"New Haven County, Connecticut",09,009,09009
885103.0,15806.0,15966.0,6936.0,14010,443046,350408,105642,62367,58963,3404,244766,183393,165401,17992,350408,75148,0.4716,38.3,379602,880624,721958,74327,48557,3082,10702,21998,"Hartford County, Connecticut",09,003,09003
923948.0,9274.0,23553.0,3678.0,4387,429878,351194,89358,53617,51635,1982,261836,183732,166885,16847,351194,51657,0.5115,38.7,405184,923664,779106,19300,18743,2983,19971,83561,"Shelby County, Tennessee",47,157,47157
27613.0,472.0,69.0,0.0,14,11196,10711,3514,2074,1996,78,7197,5580,5117,463,10711,43305,0.443,39.4,12997,27599,25068,21,121,1,168,2220,"Henderson County, Tennessee",47,077,47077
53107.0,2438.0,1314.0,191.0,68,23259,20154,7109,4679,4461,218,13045,10426,9537,889,20154,49139,0.4355,39.8,24200,52725,46593,281,493,20,573,4765,"Jefferson County, Tennessee",47,089,47089
14736.0,455.0,254.0,5.0,10,5995,5528,2010,1413,1355,58,3518,3021,2837,184,5528,49370,0.4046,39.8,6499,14579,12802,38,53,0,210,1476,"Sequatchie County, Tennessee",47,153,47153
27592.0,1089.0,440.0,62.0,0,10921,10962,3840,2361,2285,76,7122,5523,5166,357,10962,42637,0.4531,38.5,13257,27376,24638,157,80,19,69,2413,"Carroll County, Tennessee",47,017,47017
677725.0,19767.0,29523.0,6067.0,7652,372827,282366,60887,35713,33505,2208,221479,151474,123066,28408,282366,60388,0.4826,39.4,312366,680957,544153,27095,28622,4469,28642,47976,"Davidson County, Tennessee",47,037,47037
7894.0,207.0,99.0,5.0,0,2728,3073,1142,648,619,29,1931,1516,1449,67,3073,41034,0.6083,40.8,4666,7804,6496,44,7,9,36,1212,"Perry County, Tennessee",47,135,47135
12042.0,968.0,171.0,0.0,27,4405,4938,1857,1176,1149,27,3081,2440,2182,258,4938,49167,0.4204,39.8,5888,11997,10501,247,6,0,0,1243,"Meigs County, Tennessee",47,121,47121
17435.0,317.0,100.0,11.0,0,7244,7181,2341,1410,1390,20,4840,3507,3337,170,7181,37905,0.4631,39.5,8420,17395,15183,175,119,40,267,1611,"Haywood County, Tennessee",47,075,47075
196818.0,4263.0,16582.0,1449.0,732,93729,72617,13093,8416,8077,339,59524,47248,43090,4158,72617,57541,0.4162,41.2,81153,185802,163273,5069,2587,306,1292,13275,"Montgomery County, Tennessee",47,125,47125
13126.0,311.0,88.0,13.0,0,4958,4820,1806,1142,1117,25,3014,2402,2203,199,4820,40516,0.479,40.2,6460,13169,11202,17,25,0,21,1904,"Grundy County, Tennessee",47,061,47061
35352.0,627.0,571.0,156.0,1,13801,14060,5184,3413,3272,141,8876,6430,5924,506,14060,36716,0.4672,38.5,17600,35256,31092,134,74,16,63,3877,"Cocke County, Tennessee",47,029,47029
19668.0,807.0,233.0,26.0,1,7915,7704,2479,1576,1504,72,5225,4182,3897,285,7704,45511,0.4749,40.2,9622,19596,17206,103,228,5,746,1308,"DeKalb County, Tennessee",47,041,47041
11970.0,219.0,60.0,1.0,46,4792,4715,1744,1103,1045,58,2971,2207,2130,77,4715,37277,0.4372,39.4,5548,11841,10417,97,105,0,0,1222,"Lewis County, Tennessee",47,101,47101
30075.0,834.0,655.0,22.0,27,12615,12717,4388,2619,2537,82,8329,6232,5852,380,12717,39615,0.4637,39.2,14618,29908,26748,168,212,29,180,2571,"Obion County, Tennessee",47,131,47131
60766.0,2079.0,1334.0,231.0,8,27344,21452,6015,4201,4114,87,15437,12996,12305,691,21452,61291,0.4398,40.1,23833,60467,54225,554,156,41,192,5299,"Tipton County, Tennessee",47,167,47167
36982.0,1123.0,398.0,41.0,0,16051,15120,4511,2768,2645,123,10609,8677,7921,756,15120,44185,0.5245,39.6,16892,36879,33064,371,68,15,249,3112,"Dyer County, Tennessee",47,045,47045
356712.0,8106.0,12212.0,973.0,1910,169365,145213,43603,25511,24501,1010,101610,71371,63500,7871,145213,55070,0.4836,38.9,161709,356815,312435,6737,6374,925,4908,25436,"Hamilton County, Tennessee",47,065,47065
16725.0,774.0,427.0,41.0,0,6981,7383,2563,1905,1806,99,4820,3735,3433,302,7383,43306,0.4418,40.2,8880,16562,14645,27,40,74,54,1722,"Polk County, Tennessee",47,139,47139
26592.0,1173.0,153.0,26.0,0,10159,10048,3678,2156,2017,139,6370,5118,4887,231,10048,41998,0.4502,39.8,11901,26399,23154,163,78,51,43,2910,"White County, Tennessee",47,185,47185
155699.0,4314.0,4284.0,313.0,69,65399,66511,24160,14642,13879,763,42351,31256,28958,2298,66511,46684,0.4778,38.7,75205,155319,140337,1304,679,113,483,12403,"Sullivan County, Tennessee",47,163,47163
30952.0,1714.0,418.0,0.0,158,13883,12559,4655,2775,2617,158,7904,6069,5290,779,12559,57714,0.424,37.9,17488,31148,29096,587,275,41,13,1136,"Schoharie County, New York",36,095,36095
53109.0,1902.0,391.0,93.0,120,24040,22557,7385,4402,4045,357,15172,11531,10324,1207,22557,50482,0.4234,38.6,29112,52878,49438,710,176,0,54,2500,"Fulton County, New York",36,035,36035
157533.0,7185.0,4017.0,930.0,2613,79756,64906,18782,11030,10346,684,46124,33603,28873,4730,64906,68991,0.4294,38.1,73011,157380,144080,3899,3509,160,642,5090,"Rensselaer County, New York",36,083,36083
50076.0,3321.0,750.0,98.0,170,18859,19015,5970,3483,3286,197,13045,9657,8689,968,19015,50407,0.4529,38.1,25754,45835,42509,726,265,18,25,2292,"Franklin County, New York",36,033,36033
2260953.0,43030.0,16775.0,22615.0,563503,1101747,778932,249088,166828,159223,7605,529844,412777,369264,43513,778932,68666,0.4518,38.3,859529,2272058,1143856,586029,325623,36644,126875,53031,"Queens County, New York",36,081,36081
61098.0,3654.0,628.0,130.0,181,28433,24014,8242,5135,4819,316,15772,12406,10882,1524,24014,57258,0.4065,38.6,29487,58570,54193,879,304,12,88,3094,"Washington County, New York",36,115,36115
1614621.0,39838.0,60178.0,28141.0,521545,887191,759460,203907,95332,87612,7720,555553,314366,234676,79690,759460,86553,0.5956,42.2,880085,1621173,1111711,225550,199654,9688,31279,43291,"New York County, New York",36,061,36061
76595.0,3671.0,445.0,98.0,267,35549,31221,10164,6074,5644,430,21057,15972,13885,2087,31221,58377,0.4351,38.2,37077,73839,68700,818,584,37,132,3568,"Cayuga County, New York",36,011,36011
319657.0,6290.0,3121.0,1473.0,11685,144319,100438,34290,23038,22160,878,66148,55901,52777,3124,100438,93024,0.4648,37.5,106296,322460,246386,37949,20031,1865,7596,8633,"Rockland County, New York",36,087,36087
208742.0,4908.0,1737.0,416.0,1007,98856,88519,28296,15802,14879,923,60223,44500,39969,4531,88519,55522,0.4425,37.2,100373,208743,194220,5136,2548,123,310,6406,"Niagara County, New York",36,063,36063
37192.0,2021.0,772.0,334.0,62,16919,15790,6032,3668,3505,163,9758,7256,6505,751,15790,56763,0.4362,37.9,26296,35066,32731,595,489,8,72,1171,"Essex County, New York",36,031,36031
1343222.0,30597.0,8310.0,5492.0,115788,675702,446977,164993,114001,110236,3765,281984,243451,232415,11036,446977,116100,0.4578,38.6,472572,1346804,1016953,190061,80223,8016,23668,27883,"Nassau County, New York",36,059,36059
17753.0,554.0,117.0,12.0,45,8130,7324,2595,1594,1447,147,4729,3642,3171,471,7324,52327,0.4178,37.9,9795,17793,16531,188,102,3,16,953,"Schuyler County, New York",36,097,36097
47514.0,1314.0,789.0,63.0,50,21140,20697,7081,4424,4038,386,13616,10296,9189,1107,20697,52002,0.4329,38.9,25625,47305,44595,400,287,14,52,1957,"Chenango County, New York",36,017,36017
110838.0,2856.0,7419.0,1983.0,257,51958,42734,10424,6156,5885,271,32310,24704,22311,2393,42734,52685,0.4207,40.9,59969,100713,91929,1989,1479,16,178,5122,"Jefferson County, New York",36,045,36045
1469902.0,23318.0,9406.0,5228.0,46971,739441,489301,167578,112060,106173,5887,321723,266783,250253,16530,489301,101031,0.4436,38.2,575960,1471674,1204859,122312,75442,7785,24024,37252,"Suffolk County, New York",36,103,36103
39908.0,1825.0,335.0,33.0,102,18005,15917,4949,3172,3007,165,10968,8335,7503,832,15917,58052,0.3961,39.8,18208,37846,35615,236,416,17,45,1517,"Wyoming County, New York",36,121,36121
117226.0,5341.0,1076.0,342.0,448,53051,46079,13520,8364,7870,494,32559,25836,22575,3261,46079,55967,0.4324,37.2,54511,117628,110144,1270,834,77,117,5186,"Oswego County, New York",36,075,36075
89524.0,3374.0,865.0,128.0,199,43773,36720,11643,7120,6686,434,25077,19764,17880,1884,36720,59449,0.4289,38.5,41756,89743,83480,1802,671,44,127,3619,"Wayne County, New York",36,117,36117
191599.0,6499.0,2549.0,1208.0,2772,84232,78549,25791,14089,13167,922,52758,38686,32878,5808,78549,52226,0.4652,36.5,90946,190442,170052,7058,5412,370,518,7032,"Broome County, New York",36,007,36007
849.0,44.0,42.0,0.0,0,372,377,155,113,105,8,222,158,150,8,377,56339,0.4427,36.3,1461,857,762,9,0,0,3,83,"Hinsdale County, Colorado",08,053,08053
908724.0,17426.0,9926.0,4666.0,16548,441864,389585,117530,63070,59762,3308,272055,193799,169343,24456,389585,58121,0.4661,37.5,428362,907930,817124,33868,27800,978,2524,25636,"Erie County, New York",36,029,36029
74456.0,2224.0,740.0,270.0,778,32218,28184,9754,5823,5418,405,18430,13744,12392,1352,28184,57426,0.4654,38.7,50715,72998,63581,3346,1969,190,1246,2666,"Sullivan County, New York",36,105,36105
375365.0,8462.0,5347.0,1142.0,9033,176767,128016,36302,23187,21958,1229,91714,73144,67735,5409,128016,79944,0.4409,38.5,143252,371460,319189,23784,10655,1204,4716,11912,"Orange County, New York",36,071,36071
60420.0,1981.0,2062.0,30.0,45,26481,26653,10481,6220,5825,395,16172,12208,11345,863,26653,51659,0.4544,39.4,35514,60596,53726,599,289,50,516,5416,"Haywood County, North Carolina",37,087,37087
371183.0,11751.0,9529.0,1559.0,1893,170155,146816,41706,24077,22855,1222,105110,75056,68530,6526,146816,51569,0.5008,39.2,164902,372038,312293,9214,10335,2723,10023,27450,"Forsyth County, North Carolina",37,067,37067
479991.0,6650.0,15642.0,1314.0,6278,215061,186731,56670,34011,32705,1306,130061,97304,89745,7559,186731,56128,0.4495,38.8,212899,482151,419201,17229,9222,1489,4839,30171,"Lake County, Indiana",18,089,18089
37867.0,1982.0,827.0,27.0,105,18228,15382,4689,2849,2757,92,10693,8474,7603,871,15382,55522,0.394,39.3,16643,37717,33958,175,397,67,528,2592,"Montgomery County, Indiana",18,107,18107
34746.0,710.0,661.0,26.0,113,15210,12481,3730,2198,2148,50,8751,7058,6643,415,12481,52504,0.4228,38.3,13290,34932,27928,172,109,14,12,6697,"Adams County, Indiana",18,001,18001
22828.0,719.0,116.0,19.0,21,9936,9584,3120,1896,1720,176,6464,5115,4721,394,9584,46175,0.4145,40.4,10825,22854,20554,71,18,21,49,2141,"Fayette County, Indiana",18,041,18041
25935.0,942.0,184.0,3.0,16,11786,10543,3276,2121,2070,51,7267,5897,5459,438,10543,55637,0.3774,39.8,11772,25738,24515,150,36,8,0,1029,"Clay County, Indiana",18,021,18021
41835.0,775.0,240.0,7.0,0,22331,16893,4656,2695,2610,85,12237,9335,8595,740,16893,60666,0.4219,40.6,17865,41696,38240,428,1014,125,261,1628,"Dubois County, Indiana",18,037,18037
22495.0,711.0,386.0,6.0,29,11026,8687,2733,1710,1655,55,5954,5027,4821,206,8687,62462,0.413,39.5,9771,22665,21208,107,136,38,0,1176,"Franklin County, Indiana",18,047,18047
74401.0,4125.0,482.0,99.0,28,38598,28740,8297,5188,4888,300,20443,16923,15351,1572,28740,74072,0.3819,40.0,30158,74466,68417,729,649,39,88,4544,"Hancock County, Indiana",18,059,18059
81521.0,3440.0,905.0,328.0,163,36380,34701,11248,6737,6526,211,23453,17288,15922,1366,34701,52373,0.4278,38.9,39396,81330,74252,734,548,42,143,5611,"Howard County, Indiana",18,067,18067
5843.0,277.0,137.0,17.0,4,2885,2555,829,471,467,4,1726,1384,1325,59,2555,60128,0.383,41.2,2841,5821,5468,40,17,0,0,296,"Ohio County, Indiana",18,115,18115
16730.0,1328.0,274.0,38.0,23,6468,6057,2128,1530,1470,60,3929,3159,2913,246,6057,52618,0.4146,40.1,8216,15550,13234,92,105,0,9,2110,"Parke County, Indiana",18,121,18121
24544.0,547.0,515.0,38.0,34,11186,10229,3431,2014,1899,115,6798,5081,4597,484,10229,48036,0.4215,39.9,11705,24571,22007,114,137,26,163,2124,"Randolph County, Indiana",18,135,18135
8556.0,484.0,100.0,32.0,10,4022,3432,1067,618,611,7,2365,1815,1654,161,3432,49488,0.4039,39.5,3930,8598,7713,34,41,13,31,766,"Benton County, Indiana",18,007,18007
14979.0,745.0,355.0,9.0,10,6798,6189,2477,1783,1764,19,3712,3003,2744,259,6189,61030,0.4588,38.8,8686,14931,13360,219,30,0,62,1260,"Brown County, Indiana",18,013,18013
37046.0,2881.0,979.0,160.0,4,16173,13543,4312,2777,2595,182,9231,7344,6649,695,13543,61047,0.3851,38.2,15080,34525,31567,128,784,0,38,2008,"Putnam County, Indiana",18,133,18133
27577.0,892.0,300.0,74.0,21,11958,10940,3283,2092,2039,53,7657,5905,5679,226,10940,47983,0.4325,40.1,12413,27577,24954,171,17,8,6,2421,"Washington County, Indiana",18,175,18175
32625.0,999.0,318.0,61.0,31,14280,11227,3434,2067,1991,76,7793,6299,6075,224,11227,53629,0.4224,39.7,12554,32642,23513,248,443,19,351,8068,"Daviess County, Indiana",18,027,18027
47780.0,2378.0,319.0,25.0,11,19581,18304,6219,3932,3725,207,12085,9420,8582,838,18304,49832,0.4233,39.8,21201,44895,41538,205,25,1,27,3099,"Henry County, Indiana",18,065,18065
36595.0,2499.0,649.0,54.0,66,17778,15038,4673,2546,2440,106,10365,7952,7137,815,15038,47380,0.4363,39.2,17114,36228,32998,188,239,25,29,2749,"Knox County, Indiana",18,083,18083
128078.0,5821.0,1579.0,167.0,152,56713,51003,16519,9823,9432,391,34484,26173,23845,2328,51003,49522,0.4305,38.5,59082,124753,112863,616,989,73,566,9646,"Madison County, Indiana",18,095,18095
12255.0,376.0,75.0,3.0,39,5528,5129,1662,973,948,25,3467,2568,2329,239,5129,50194,0.3796,40.3,5787,12168,11507,142,31,0,8,480,"Pike County, Indiana",18,125,18125
12448.0,676.0,100.0,23.0,10,5353,5151,1695,1030,965,65,3456,2558,2384,174,5151,49580,0.4043,40.2,6110,12453,11387,122,34,0,29,881,"Pulaski County, Indiana",18,131,18131
34126.0,1336.0,804.0,12.0,28,17303,14261,4632,3036,2831,205,9629,7454,6628,826,14261,58279,0.4003,39.4,19986,34215,31205,178,237,0,153,2442,"Steuben County, Indiana",18,151,18151
97136.0,1628.0,5555.0,318.0,256,48514,39683,10996,6682,6336,346,28687,21767,19936,1831,39683,66910,0.4373,40.9,43384,94732,84682,1463,1099,55,630,6803,"Laramie County, Wyoming",56,021,56021
22906.0,359.0,1957.0,439.0,493,14096,9019,2302,1479,1316,163,6717,4951,3874,1077,9019,84678,0.5003,40.7,13848,23215,18771,604,881,66,1186,1707,"Teton County, Wyoming",56,039,56039
27779.0,2180.0,638.0,50.0,51,10101,10043,4191,2544,2470,74,5852,4594,4210,384,10043,41614,0.4528,41.1,13939,28041,21770,398,413,43,842,4575,"San Jacinto County, Texas",48,407,48407
40571.0,2300.0,731.0,7.0,8,16792,14108,4959,3296,3217,79,9149,7162,6824,338,14108,52162,0.4435,41.2,17055,40474,32921,341,444,121,605,6042,"Upshur County, Texas",48,459,48459
51382.0,3948.0,467.0,173.0,139,22826,15171,4076,2929,2749,180,11095,9213,8102,1111,15171,59642,0.4677,38.5,17020,51619,37328,1300,2505,400,2968,7118,"Waller County, Texas",48,473,48473
48425.0,2220.0,533.0,178.0,0,21637,15733,4639,3532,3430,102,11094,9492,9081,411,15733,76692,0.4294,41.7,17564,48518,41035,701,530,196,390,5666,"Wilson County, Texas",48,493,48493
22795.0,1623.0,218.0,96.0,10,9991,7997,2371,1321,1311,10,5626,4561,4326,235,7997,48248,0.428,41.2,9384,22835,17758,491,569,202,670,3145,"Hockley County, Texas",48,219,48219
165450.0,9701.0,4800.0,1308.0,131,84501,56998,12062,7525,7215,310,44936,34464,31789,2675,56998,79421,0.4719,42.8,61301,166878,123402,6603,9201,1489,5734,20449,"Midland County, Texas",48,329,48329
20807.0,1867.0,405.0,41.0,0,7485,8678,5007,3279,3099,180,3671,2843,2642,201,8678,53411,0.5223,39.6,15335,20835,16829,187,221,84,388,3126,"Llano County, Texas",48,299,48299
34290.0,3847.0,469.0,70.0,0,13800,12453,4343,2650,2558,92,8110,6442,6100,342,12453,54648,0.4559,41.8,14464,31653,25668,353,491,54,605,4482,"Fannin County, Texas",48,147,48147
220138.0,21812.0,5855.0,3068.0,1996,104332,79412,13652,8751,8549,202,65760,48004,36244,11760,79412,49181,0.5149,36.8,89824,218617,170518,7517,13691,1219,7307,18365,"Brazos County, Texas",48,041,48041
20184.0,515.0,752.0,80.0,0,8098,5812,1319,806,795,11,4493,3875,3750,125,5812,63054,0.4631,43.3,6501,20597,11316,1215,1115,847,2232,3872,"Gaines County, Texas",48,165,48165
22145.0,1228.0,500.0,6.0,0,8851,7884,2551,1466,1454,12,5333,4140,3712,428,7884,47952,0.4563,41.8,10030,20803,15606,673,505,185,761,3073,"Gray County, Texas",48,179,48179
8780.0,1149.0,40.0,0.0,0,3136,3168,1003,690,676,14,2165,1675,1570,105,3168,52045,0.4648,44.4,4166,7717,6126,93,108,32,191,1167,"Jack County, Texas",48,237,48237
18111.0,1022.0,134.0,15.0,2,7586,7211,2917,2038,1938,100,4294,3536,3409,127,7211,52148,0.4217,40.4,9767,17952,14196,280,379,129,381,2587,"Bosque County, Texas",48,035,48035
1927070.0,45593.0,44074.0,14095.0,22112,908944,636245,157549,102922,98778,4144,478696,355683,322479,33204,636245,57157,0.4688,39.3,693478,1922572,1453376,91591,84831,14117,65751,212906,"Bexar County, Texas",48,029,48029
3543.0,82.0,27.0,0.0,0,1511,1530,644,247,224,23,886,745,714,31,1530,40739,0.4084,42.7,2645,3499,2925,62,1,0,40,471,"Baylor County, Texas",48,023,48023
824642.0,55697.0,24892.0,6800.0,3708,445453,290229,55555,38505,37208,1297,234674,184159,166867,17292,290229,86913,0.4322,40.0,308586,830187,640367,52391,44466,7505,24942,60516,"Denton County, Texas",48,121,48121
328292.0,18770.0,6129.0,1483.0,1370,154635,121438,33140,21369,20292,1077,88298,70266,64694,5572,121438,73330,0.4646,40.5,146445,327847,262350,11913,7991,1685,11037,32871,"Galveston County, Texas",48,167,48167
802.0,79.0,2.0,0.0,0,355,301,123,93,92,1,178,150,142,8,301,68750,0.371,41.1,426,805,699,21,0,0,0,85,"Roberts County, Texas",48,393,48393
26516.0,700.0,559.0,204.0,0,11037,8841,3098,1931,1919,12,5743,4628,4244,384,8841,41679,0.4555,39.1,11160,26460,19799,864,1217,231,618,3731,"Uvalde County, Texas",48,463,48463
92405.0,2121.0,2510.0,220.0,152,36579,34076,10566,6461,6351,110,23510,17714,16683,1031,34076,50164,0.4995,40.2,39827,87808,73784,1001,919,203,1109,10792,"Bowie County, Texas",48,037,48037
634.0,89.0,0.0,0.0,0,242,273,109,65,60,5,164,109,102,7,273,44688,0.4897,42.7,491,601,560,12,0,0,0,29,"Kent County, Texas",48,263,48263
8799.0,766.0,33.0,0.0,34,3605,3123,1151,835,788,47,1972,1776,1757,19,3123,60632,0.4475,39.5,3844,8675,7209,216,70,14,38,1128,"Somervell County, Texas",48,425,48425
56002.0,2214.0,535.0,79.0,57,23842,20626,6441,4127,4093,34,14185,11442,10892,550,20626,60339,0.4663,40.3,24752,56320,47717,238,371,92,424,7478,"Hardin County, Texas",48,199,48199
16987.0,867.0,142.0,35.0,0,6190,6443,2825,1761,1741,20,3618,2853,2622,231,6443,43045,0.5271,40.8,9791,17136,13900,155,162,96,484,2339,"Leon County, Texas",48,289,48289
13768.0,406.0,69.0,22.0,13,4993,5315,2015,1401,1374,27,3300,2625,2511,114,5315,40101,0.4603,40.1,7359,13729,10918,34,26,44,47,2660,"Newton County, Texas",48,351,48351
15279.0,601.0,505.0,363.0,0,5774,3518,1161,797,760,37,2357,1856,1795,61,3518,53311,0.4465,44.4,4641,13635,9881,458,519,31,146,2600,"Reeves County, Texas",48,389,48389
1211708.0,47549.0,36699.0,11576.0,19525,677329,472361,82570,52236,49116,3120,389791,272764,220179,52585,472361,75887,0.4832,39.9,514410,1219139,907775,67609,84183,9302,56285,93985,"Travis County, Texas",48,453,48453
2929.0,83.0,115.0,0.0,0,1286,1035,330,218,218,0,705,554,540,14,1035,39120,0.5212,37.9,1489,2904,2145,30,53,68,107,501,"Collingsworth County, Texas",48,087,48087
41221.0,3385.0,610.0,204.0,8,19736,13595,3618,2324,2217,107,9977,7497,6473,1024,13595,52742,0.4938,37.2,18181,41333,32139,756,1502,228,1122,5586,"Erath County, Texas",48,143,48143
1231.0,141.0,29.0,0.0,7,572,489,237,159,159,0,252,165,154,11,489,43859,0.4758,43.6,778,1252,1022,0,0,0,0,230,"Motley County, Texas",48,345,48345
8248.0,218.0,57.0,0.0,8,3496,3423,1431,833,754,79,1992,1570,1373,197,3423,46743,0.4669,40.3,5549,8299,6170,155,48,7,254,1665,"Coleman County, Texas",48,083,48083
49502.0,3387.0,314.0,51.0,8,21065,15682,5585,3731,3547,184,10097,8598,8076,522,15682,62599,0.4525,40.9,18655,47579,38883,1274,748,359,183,6132,"Medina County, Texas",48,325,48325
80003.0,4092.0,1172.0,73.0,167,31861,30757,12387,8194,7893,301,18370,14909,13590,1319,30757,47355,0.4702,40.1,41246,80091,63715,806,1245,318,1492,12515,"Henderson County, Texas",48,213,48213
49064.0,1667.0,897.0,70.0,30,21258,19793,6714,3839,3743,96,13079,10140,9458,682,19793,45117,0.475,41.0,22774,49061,40023,621,418,94,850,7055,"Lamar County, Texas",48,277,48277
4286.0,232.0,97.0,6.0,11,1988,1783,870,580,580,0,913,717,691,26,1783,43328,0.5252,39.9,3268,4334,3438,51,51,45,30,719,"Kimble County, Texas",48,267,48267
34919.0,2358.0,249.0,220.0,1,15294,12625,5038,3184,3184,0,7587,5862,5415,447,12625,54971,0.5113,39.5,16206,34469,29392,513,575,157,1299,2533,"Washington County, Texas",48,477,48477
9184.0,809.0,39.0,94.0,20,3601,3247,1146,738,712,26,2101,1680,1571,109,3247,46232,0.4819,41.5,4958,8943,6945,138,141,26,150,1543,"Stephens County, Texas",48,429,48429
17736.0,1039.0,140.0,37.0,10,8130,5573,1190,831,791,40,4383,3648,3482,166,5573,76158,0.4237,44.5,6296,17943,12616,606,1171,166,784,2600,"Andrews County, Texas",48,003,48003
20396.0,936.0,58.0,11.0,45,8795,7364,2419,1591,1567,24,4945,3930,3847,83,7364,53577,0.4829,43.2,8998,20450,15445,407,795,52,1140,2611,"Gonzales County, Texas",48,177,48177
5761.0,559.0,38.0,7.0,0,2337,2154,721,397,393,4,1433,1186,1142,44,2154,43382,0.5022,43.8,2677,5789,4546,49,113,23,133,925,"Lynn County, Texas",48,305,48305
14002.0,560.0,57.0,64.0,0,4910,4503,1353,854,749,105,3150,2626,2535,91,4503,33952,0.5641,38.6,6454,14267,8460,533,1206,253,1500,2315,"Zapata County, Texas",48,505,48505
57706.0,3140.0,1150.0,220.0,52,24593,22152,9183,6433,6183,250,12969,10252,9697,555,22152,64041,0.4714,41.3,26396,57636,47995,713,350,255,264,8059,"Hood County, Texas",48,221,48221
237.0,8.0,0.0,0.0,6,113,77,20,10,10,0,57,45,37,8,77,52083,0.3522,49.5,124,237,188,0,39,1,2,7,"King County, Texas",48,269,48269
51436.0,2306.0,637.0,127.0,52,19977,18138,5938,3965,3771,194,12200,9931,9479,452,18138,48186,0.4325,39.6,21287,49386,37324,1007,1658,457,2420,6520,"Cherokee County, Texas",48,073,48073
5192.0,398.0,105.0,0.0,6,2083,1999,729,498,491,7,1270,969,925,44,1999,51038,0.4372,40.0,2488,5183,4553,39,5,13,7,566,"Delta County, Texas",48,119,48119
19794.0,4121.0,77.0,0.0,1,4946,5696,2115,1330,1324,6,3581,2986,2695,291,5696,50344,0.4435,40.6,7337,12839,10609,98,142,23,70,1897,"Jones County, Texas",48,253,48253
115828.0,3966.0,2815.0,285.0,336,57149,44953,12820,8184,7776,408,32133,24808,21889,2919,44953,66550,0.4217,37.0,49718,114847,105699,2462,1959,87,1013,3627,"Windham County, Connecticut",09,015,09015
265277.0,6162.0,10261.0,1297.0,1982,137099,107827,32937,20335,19318,1017,74890,56433,50296,6137,107827,73490,0.4425,38.1,123426,255286,225143,12082,7798,627,2248,7388,"New London County, Connecticut",09,011,09011
161596.0,6980.0,2608.0,1006.0,1282,86720,66971,21863,13483,12538,945,45108,33835,30036,3799,66971,85898,0.4462,38.6,76327,161015,144787,7225,3838,268,1262,3635,"Middlesex County, Connecticut",09,007,09007
149919.0,9016.0,3926.0,966.0,1431,76781,55683,15964,10389,9705,684,39719,31290,25970,5320,55683,87069,0.4383,36.1,59686,148476,134694,5485,4486,81,283,3447,"Tolland County, Connecticut",09,013,09013
933549.0,7487.0,25767.0,9275.0,47049,468064,340189,102053,63979,60706,3273,238136,191417,175868,15549,340189,95645,0.5422,38.6,372565,935939,699791,93219,64125,6726,42892,29186,"Fairfield County, Connecticut",09,001,09001
24546.0,2226.0,260.0,3.0,36,8347,8827,3027,1848,1682,166,5800,4502,4240,262,8827,37022,0.4277,38.3,10922,21952,18578,246,308,23,64,2733,"Washington County, Florida",12,133,12133
923002.0,23334.0,27354.0,7794.0,8296,458734,359544,92269,56332,53027,3305,267275,193241,170168,23073,359544,55807,0.4704,39.6,407960,915341,728669,50340,28333,6787,17098,84114,"Duval County, Florida",12,031,12031
27188.0,2271.0,321.0,18.0,46,9350,9115,3267,2114,2005,109,5848,4399,3884,515,9115,45921,0.4487,38.8,11051,23463,20274,374,169,89,54,2503,"Bradford County, Florida",12,007,12007
579881.0,12099.0,21433.0,3794.0,1338,249363,230417,92648,57397,53691,3706,137769,101883,91632,10251,230417,56775,0.4505,38.0,278173,580488,479490,29200,12734,2667,4957,51440,"Brevard County, Florida",12,009,12009
209428.0,13494.0,8999.0,1214.0,151,96844,74333,22099,15307,14915,392,52234,44146,41628,2518,74333,65740,0.4171,39.5,80710,208638,174830,8692,3698,893,1207,19318,"Clay County, Florida",12,019,12019
8566.0,849.0,29.0,29.0,2,2402,2175,798,438,420,18,1377,1160,1115,45,2175,50165,0.4203,43.3,3193,7102,5520,198,205,22,32,1125,"Lafayette County, Florida",12,067,12067
342432.0,17828.0,11436.0,2116.0,460,139628,134317,60940,40285,37774,2511,73377,58205,53304,4901,134317,54513,0.4231,39.7,157039,342444,280533,17614,9011,1717,4316,29253,"Lake County, Florida",12,069,12069
82299.0,2447.0,3064.0,159.0,60,37444,32603,11959,8645,8273,372,20644,17074,15679,1395,32603,69943,0.4433,39.6,38975,81911,70753,1950,643,215,723,7627,"Nassau County, Florida",12,089,12089
956990.0,20786.0,31340.0,5881.0,7467,447044,407546,161276,90606,82631,7975,246270,170775,146412,24363,407546,54090,0.4851,39.0,509132,953053,755054,60534,33657,8321,13733,81754,"Pinellas County, Florida",12,103,12103
678790.0,23727.0,21130.0,5085.0,1476,281139,235283,89797,60050,56928,3122,145486,115745,104541,11204,235283,50584,0.4452,38.6,295456,678029,542248,28589,21156,3958,14743,67335,"Polk County, Florida",12,105,12105
310433.0,14378.0,8276.0,1752.0,534,130598,114761,48489,33215,30460,2755,66272,51636,47028,4608,114761,52322,0.4416,38.7,141628,310499,228983,26238,12664,4128,9249,29237,"St. Lucie County, Florida",12,111,12111
13474.0,927.0,401.0,178.0,49,3665,4700,2402,1500,1372,128,2298,1864,1741,123,4700,40977,0.4343,39.4,7056,12316,8367,491,490,33,494,2441,"Glades County, Florida",12,043,12043
40202.0,1178.0,479.0,1482.0,1146,17246,12527,3621,2556,2269,287,8906,7048,6700,348,12527,40820,0.4681,40.3,14804,40192,23765,2951,3179,758,4325,5214,"Hendry County, Florida",12,051,12051
152728.0,4392.0,5469.0,1110.0,224,57577,58612,31331,19693,18375,1318,27281,20027,18257,1770,58612,54740,0.5246,38.4,80098,152683,123345,6548,4749,787,3067,14187,"Indian River County, Florida",12,061,12061
47399.0,3999.0,851.0,127.0,12,16536,17149,6361,3658,3510,148,10788,8171,7642,529,17149,39872,0.4585,38.3,21102,40591,35442,362,200,26,330,4231,"Jackson County, Florida",12,063,12063
242547.0,12956.0,12285.0,1768.0,171,111530,88773,31331,21513,20170,1343,57442,47777,44158,3619,88773,82252,0.4667,39.2,107258,243056,207544,11170,4869,582,985,17906,"St. Johns County, Florida",12,109,12109
457552.0,23978.0,13357.0,4171.0,2225,229927,173668,48036,32159,30929,1230,125632,96914,86011,10903,173668,66768,0.4568,39.0,190156,458233,359434,35731,19361,3923,5765,34019,"Seminole County, Florida",12,117,12117
179784.0,4234.0,9071.0,737.0,877,84130,71422,21930,13656,12985,671,49492,36882,32830,4052,71422,54316,0.4427,39.2,103059,177278,145746,5251,2998,474,2431,20378,"Bay County, Florida",12,005,12005
109177.0,3172.0,5311.0,928.0,137,42518,42121,21296,14965,14025,940,20825,17006,15303,1703,42121,54514,0.4359,37.7,51757,109347,83605,8439,2615,934,1390,12364,"Flagler County, Florida",12,035,12035
15511.0,1988.0,499.0,48.0,2,5687,5757,2318,1580,1490,90,3439,2553,2411,142,5757,47712,0.4158,38.2,9567,13110,11541,155,45,12,98,1259,"Gulf County, Florida",12,045,12045
8266.0,850.0,20.0,5.0,0,2247,2459,812,533,523,10,1647,1183,1091,92,2459,38015,0.4305,40.3,3621,6948,5531,255,109,0,10,1043,"Liberty County, Florida",12,077,12077
348022.0,13386.0,8441.0,8048.0,1641,161381,103141,28950,21735,20722,1013,74191,59850,54842,5008,103141,52279,0.4258,38.2,149427,350493,242677,33358,23652,4846,11745,34215,"Osceola County, Florida",12,097,12097
67349.0,2887.0,2973.0,51.0,85,29905,27420,9368,5936,5554,382,18052,14027,12715,1312,27420,58093,0.483,39.5,51996,66278,54907,2046,805,303,858,7359,"Walton County, Florida",12,131,12131
45492.0,3098.0,203.0,4.0,46,16634,17149,5999,3591,3479,112,11150,8318,7742,576,17149,41401,0.4448,39.3,20293,42923,35660,512,699,168,819,5065,"Gadsden County, Florida",12,039,12039
14026.0,1351.0,311.0,46.0,0,4905,5770,2282,1519,1512,7,3488,2432,2249,183,5770,47240,0.4601,39.7,6752,12079,10805,138,258,0,40,838,"Jefferson County, Florida",12,065,12065
350795.0,12144.0,10866.0,1266.0,475,123940,139172,67054,44323,42064,2259,72118,53546,49201,4345,139172,45371,0.4544,38.6,168985,344766,283947,15529,5861,1411,3575,34443,"Marion County, Florida",12,083,12083
26988.0,644.0,116.0,60.0,265,9563,7863,2696,1836,1727,109,5167,4126,3885,241,7863,38682,0.4684,40.7,9763,25395,20713,842,876,141,631,2192,"Hardee County, Florida",12,049,12049
40655.0,1319.0,694.0,74.0,19,15192,13904,5227,3458,3177,281,8677,6685,6202,483,13904,41760,0.4556,40.1,18679,38147,29603,1216,1183,263,1664,4218,"Okeechobee County, Florida",12,093,12093
1334861.0,52498.0,37498.0,23755.0,16148,677192,461705,106532,74185,70012,4173,355173,272460,234874,37586,461705,58254,0.4848,38.9,535981,1338194,937401,132511,90574,17430,50253,110025,"Orange County, Florida",12,095,12095
17858.0,1397.0,225.0,30.0,2,6524,6464,2463,1672,1581,91,4001,2975,2767,208,6464,43640,0.4266,38.8,7550,16608,13295,210,184,9,215,2695,"Gilchrist County, Florida",12,041,12041
43614.0,2554.0,351.0,47.0,4,16361,14888,5722,4089,3919,170,9166,7265,6771,494,14888,47839,0.459,39.6,19401,42517,35443,550,601,163,837,4923,"Suwannee County, Florida",12,121,12121
263110.0,17880.0,6505.0,2802.0,4373,123725,97995,24506,14440,13580,860,73489,47119,36704,10415,97995,49689,0.5111,36.3,117415,262894,216109,12515,12056,955,2396,18863,"Alachua County, Florida",12,001,12001
14235.0,1302.0,330.0,29.0,0,4703,4501,1757,972,931,41,2744,1938,1800,138,4501,38568,0.4571,41.6,6017,12336,10150,127,28,0,29,2002,"Calhoun County, Florida",12,013,12013
179970.0,6489.0,8652.0,824.0,113,60672,76891,45507,30150,27930,2220,31384,23887,21100,2787,76891,51499,0.4602,38.3,104458,177693,142911,10919,5389,965,2282,15227,"Charlotte County, Florida",12,015,12015
16454.0,1234.0,308.0,1.0,2,4915,6504,2752,1860,1787,73,3752,2938,2588,350,6504,39828,0.4751,38.1,9453,15011,12311,215,55,11,110,2309,"Dixie County, Florida",12,029,12029
157888.0,7485.0,5011.0,1169.0,145,64998,64528,32063,19250,17480,1770,32465,24140,21981,2159,64528,61133,0.5278,38.0,80153,155929,127759,7372,4511,858,2898,12531,"Martin County, Florida",12,085,12085
416654.0,10191.0,16728.0,2820.0,1337,167112,182842,99123,62608,57539,5069,83719,61954,54406,7548,182842,62236,0.4809,38.7,240766,415664,328864,26543,14531,3199,7404,35123,"Sarasota County, Florida",12,115,12115
381001.0,12871.0,15433.0,2644.0,1296,160047,145356,66243,42888,40092,2796,79113,61206,55631,5575,145356,59009,0.4709,38.7,191000,381199,299870,19624,15169,2204,11064,33268,"Manatee County, Florida",12,081,12081
144383.0,5804.0,5025.0,537.0,137,45250,63681,34857,22851,21328,1523,28824,20353,18263,2090,63681,44237,0.4517,38.4,79641,142910,121423,4814,2150,236,556,13731,"Citrus County, Florida",12,017,12017
27765.0,2850.0,382.0,88.0,0,10612,8693,2649,1765,1660,105,6044,4979,4576,403,8693,63275,0.422,39.6,9994,25324,22500,239,56,52,0,2477,"Baker County, Florida",12,003,12003
172674.0,8551.0,10176.0,1000.0,32,76904,63514,19196,13511,12719,792,44318,36749,34168,2581,63514,67949,0.4196,40.0,71649,165459,142835,4947,2237,297,595,14548,"Santa Rosa County, Florida",12,113,12113
286961.0,19959.0,8658.0,1748.0,2546,143886,113658,27085,16488,15718,770,86573,61627,45996,15631,113658,53106,0.4896,36.2,130005,286368,245898,9369,7950,653,1679,20819,"Leon County, Florida",12,073,12073
1904743.0,43711.0,33498.0,31671.0,24825,948166,690050,217635,134956,125046,9910,472415,353351,315630,37721,690050,59547,0.4884,38.8,823499,1914269,1129610,343047,170527,46190,94120,130775,"Broward County, Florida",12,011,12011
75034.0,2194.0,3936.0,1013.0,398,40537,32068,11701,7543,6744,799,20367,14835,12054,2781,32068,70033,0.5049,40.2,53518,73835,50971,5802,3630,1337,3539,8556,"Monroe County, Florida",12,087,12087
184659.0,8605.0,6032.0,953.0,182,67649,75348,34850,23299,21808,1491,40498,31959,29143,2816,75348,48812,0.4293,38.9,86898,184390,151203,8142,2542,842,1076,20585,"Hernando County, Florida",12,053,12053
1406640.0,41439.0,42015.0,17150.0,9628,689904,526175,136588,87632,82116,5516,389587,286661,249818,36843,526175,58884,0.4787,39.3,580511,1410780,1047423,107793,77843,16196,46943,114582,"Hillsborough County, Florida",12,057,12057
21670.0,2298.0,133.0,88.0,1,6276,7405,3030,1971,1920,51,4375,3449,3277,172,7405,40306,0.4115,40.1,11112,18108,15972,280,110,0,20,1726,"Taylor County, Florida",12,123,12123
32092.0,2180.0,309.0,97.0,4,13331,11200,3452,2194,2028,166,7748,6520,6035,485,11200,61410,0.4175,40.9,13479,28914,25912,311,114,23,16,2538,"Wakulla County, Florida",12,129,12129
21170.0,854.0,733.0,6.0,0,8416,8153,2593,1783,1625,158,5560,4477,4145,332,8153,43468,0.4518,39.7,9350,21094,18199,285,64,20,163,2363,"McDuffie County, Georgia",13,189,13189
18360.0,1025.0,76.0,10.0,29,8296,6942,2534,1756,1699,57,4408,3661,3551,110,6942,66178,0.4517,40.5,7753,18322,16005,108,151,48,59,1951,"Morgan County, Georgia",13,211,13211
11582.0,687.0,249.0,0.0,10,4934,4502,1498,968,943,25,3004,2479,2311,168,4502,51358,0.4038,40.5,5201,11587,10076,75,52,0,84,1300,"Heard County, Georgia",13,149,13149
88156.0,4636.0,1759.0,152.0,573,34301,34087,9817,5547,5233,314,24270,16822,15477,1345,34087,39584,0.4933,38.4,40610,87791,72131,631,586,33,589,13821,"Dougherty County, Georgia",13,095,13095
25112.0,1269.0,726.0,54.0,30,9546,10408,4791,3210,2991,219,5617,4379,4092,287,10408,47997,0.4539,38.1,17239,25238,21457,212,70,4,99,3396,"Fannin County, Georgia",13,111,13111
150915.0,5692.0,4850.0,1020.0,55,72611,57056,13347,8773,8562,211,43709,34698,32000,2698,57056,61723,0.4327,38.6,63018,149785,126536,3789,2094,336,2548,14482,"Houston County, Georgia",13,153,13153
46776.0,989.0,665.0,68.0,8,17217,17142,5729,3568,3384,184,11413,8619,8165,454,17142,39120,0.4997,38.3,21573,46528,40499,421,283,39,76,5210,"Laurens County, Georgia",13,175,13175
64511.0,3048.0,689.0,99.0,59,26288,24336,8047,5341,5149,192,16289,12442,11311,1131,24336,47111,0.4536,39.0,27407,64205,53439,826,652,68,479,8741,"Spalding County, Georgia",13,255,13255
15786.0,341.0,90.0,69.0,1,5016,4668,1686,1096,1037,59,2982,2266,2222,44,4668,32405,0.4803,40.8,7280,12814,11554,5,0,0,13,1242,"Telfair County, Georgia",13,271,13271
8165.0,450.0,50.0,28.0,16,3835,3357,1116,743,741,2,2241,1859,1773,86,3357,60553,0.407,40.7,3747,8147,7664,24,16,0,28,415,"Warren County, Indiana",18,171,18171
15321.0,525.0,180.0,4.0,43,6658,6664,2132,1278,1254,24,4532,3573,3203,370,6664,50243,0.4205,39.6,7508,15322,14312,39,65,0,26,880,"Vermillion County, Indiana",18,165,18165
27774.0,1689.0,208.0,53.0,57,13895,10888,3306,1968,1903,65,7582,6210,5866,344,10888,59237,0.3978,38.6,11871,27373,25342,226,89,25,36,1655,"Wells County, Indiana",18,179,18179
367474.0,7235.0,7995.0,1625.0,1326,179225,145065,37433,21494,20544,950,107632,81174,73043,8131,145065,54857,0.4458,38.5,158116,369020,317889,10296,9111,1384,4168,26172,"Allen County, Indiana",18,003,18003
26420.0,881.0,259.0,42.0,72,13124,10353,2958,1941,1890,51,7395,5648,5045,603,10353,57949,0.385,40.5,11386,26219,24190,214,268,0,32,1515,"Decatur County, Indiana",18,031,18031
113855.0,8187.0,2503.0,264.0,951,51709,46026,13414,8034,7702,332,32612,23839,19424,4415,46026,43512,0.4811,35.9,52716,113571,102480,979,955,14,497,8646,"Delaware County, Indiana",18,035,18035
76441.0,2551.0,1654.0,230.0,259,38085,29189,7966,5014,4713,301,21223,15840,14671,1169,29189,64468,0.4447,38.9,32809,76195,71057,985,497,72,361,3223,"Floyd County, Indiana",18,043,18043
31696.0,1435.0,907.0,56.0,17,14161,12632,4042,2357,2222,135,8590,6523,6018,505,12632,52718,0.4525,39.1,14477,30578,28071,179,117,30,78,2103,"Jefferson County, Indiana",18,077,18077
27436.0,1282.0,163.0,85.0,42,13685,10792,3336,2142,2100,42,7456,5754,5291,463,10792,54191,0.4172,40.5,12316,27428,24847,94,112,51,93,2231,"Jennings County, Indiana",18,079,18079
152114.0,8792.0,3057.0,511.0,357,78434,56628,15246,9441,9228,213,41382,34057,31227,2830,56628,72440,0.4144,39.6,60915,151655,135875,2778,2506,554,1080,8862,"Johnson County, Indiana",18,081,18081
35455.0,2260.0,562.0,28.0,29,15019,13611,4432,2579,2427,152,9179,7189,6732,457,13611,50657,0.4045,39.1,15405,33568,30428,157,82,22,49,2830,"Miami County, Indiana",18,103,18103
69307.0,4264.0,660.0,59.0,33,32770,26034,7799,5228,5002,226,18235,14904,13732,1172,26034,64335,0.4046,38.8,28394,68934,63145,535,408,0,59,4787,"Morgan County, Indiana",18,109,18109
33145.0,946.0,564.0,50.0,27,16344,13340,3959,2412,2284,128,9381,7627,7069,558,13340,55462,0.4053,40.3,15205,33057,30468,116,384,54,26,2009,"Gibson County, Indiana",18,051,18051
13796.0,920.0,231.0,5.0,32,5947,5573,1915,1200,1148,52,3658,2866,2687,179,5573,55356,0.378,39.6,6085,13767,12607,93,121,0,153,793,"Newton County, Indiana",18,111,18111
19303.0,588.0,112.0,54.0,6,8623,7898,2606,1566,1503,63,5292,4115,3820,295,7898,47917,0.428,39.8,9218,19273,17468,199,117,7,28,1454,"Orange County, Indiana",18,117,18117
266628.0,5694.0,8544.0,1356.0,1626,126809,101872,29151,16557,15957,600,72721,53273,48048,5225,101872,52769,0.4689,38.0,116713,267710,232079,6328,7438,714,2975,18176,"St. Joseph County, Indiana",18,141,18141
77966.0,3754.0,1514.0,289.0,86,38910,30997,9074,5944,5690,254,21923,17815,16161,1654,30997,61366,0.4093,39.8,38526,78271,67321,1278,1837,48,664,7123,"Kosciusko County, Indiana",18,085,18085
45963.0,1868.0,395.0,119.0,105,20733,17304,5555,3296,3098,198,11749,9493,8865,628,17304,52658,0.4334,38.9,20255,45914,38745,547,838,136,759,4889,"Marshall County, Indiana",18,099,18099
10599.0,444.0,98.0,7.0,0,4501,4349,1342,823,774,49,3007,2460,2283,177,4349,49383,0.4329,39.7,5335,10588,9243,124,66,12,0,1143,"Switzerland County, Indiana",18,155,18155
179560.0,6944.0,4999.0,419.0,1411,86555,75607,20829,11838,11280,558,54778,38320,33463,4857,75607,49708,0.4773,38.9,84249,178940,161167,1990,1968,130,1039,12646,"Vanderburgh County, Indiana",18,163,18163
11849.0,437.0,168.0,35.0,26,5118,5235,1777,1019,1008,11,3458,2694,2466,228,5235,43505,0.4259,39.2,6019,11857,11022,103,75,0,36,621,"Blackford County, Indiana",18,009,18009
23615.0,1135.0,255.0,11.0,0,10078,8971,2734,1619,1581,38,6237,5046,4635,411,8971,48700,0.4076,40.5,10637,23351,21200,65,98,0,115,1873,"Scott County, Indiana",18,143,18143
145316.0,11583.0,7268.0,1883.0,2735,71551,55624,13048,7577,7247,330,42576,29871,22026,7845,55624,49839,0.4911,34.4,61600,145376,124912,3211,7196,181,1378,8498,"Monroe County, Indiana",18,105,18105
201388.0,4722.0,3366.0,611.0,265,94790,71718,19738,12857,12235,622,51980,40748,37830,2918,71718,57021,0.4263,38.7,79096,201957,162565,4360,5571,1096,4914,23451,"Elkhart County, Indiana",18,039,18039
10466.0,260.0,90.0,18.0,21,4184,3835,1378,878,837,41,2457,1853,1715,138,3835,41662,0.4557,39.2,5560,10501,9771,23,0,0,0,707,"Crawford County, Indiana",18,025,18025
37461.0,1508.0,310.0,119.0,84,17396,14688,4719,2601,2493,108,9969,7452,6993,459,14688,49415,0.42,39.2,16369,37027,31214,704,1637,121,992,2359,"Cass County, Indiana",18,017,18017
939402.0,24203.0,17443.0,5108.0,7830,458406,372358,84760,45537,42541,2996,287598,186413,160385,26028,372358,48316,0.4839,38.9,423346,941905,779998,24584,38726,3622,23635,71340,"Marion County, Indiana",18,097,18097
65757.0,1360.0,1918.0,208.0,86,29642,26644,8929,5157,4814,343,17715,13653,12406,1247,26644,46516,0.4621,39.1,31372,64974,55995,406,820,195,156,7402,"Wayne County, Indiana",18,177,18177
14409.0,533.0,95.0,28.0,3,7056,6254,2138,1291,1252,39,4116,3230,2998,232,6254,57115,0.4157,39.4,6784,14376,13772,108,25,0,0,471,"Butler County, Iowa",19,023,19023
6864.0,169.0,219.0,23.0,0,3211,2945,1045,660,606,54,1900,1521,1344,177,2945,56750,0.4074,40.7,3454,6836,6357,109,56,0,3,311,"Fremont County, Iowa",19,071,19071
14828.0,474.0,124.0,47.0,1,7276,6259,1905,1176,1111,65,4354,3148,3021,127,6259,60910,0.4115,39.8,7195,14800,13808,344,204,3,108,333,"Hamilton County, Iowa",19,079,19079
6117.0,208.0,98.0,74.0,18,2943,2616,956,543,513,30,1660,1280,1116,164,2616,50431,0.4497,42.4,3105,6072,5485,65,62,0,117,343,"Taylor County, Iowa",19,173,19173
12167.0,671.0,214.0,12.0,40,5955,5176,1714,966,924,42,3462,2625,2266,359,5176,49900,0.4328,39.4,5942,12230,11215,146,113,0,23,733,"Union County, Iowa",19,175,19175
7338.0,328.0,100.0,4.0,4,3872,3172,1023,591,580,11,2149,1647,1477,170,3172,57130,0.4113,39.8,3524,7342,6980,36,18,0,0,308,"Worth County, Iowa",19,195,19195
4920.0,199.0,77.0,17.0,9,2158,1971,691,433,423,10,1280,981,900,81,1971,55271,0.4236,41.9,2614,4752,4495,3,60,0,5,189,"Ringgold County, Iowa",19,159,19159
7056.0,511.0,169.0,2.0,13,3455,3200,1113,631,606,25,2087,1587,1415,172,3200,53363,0.4298,42.1,3711,6961,6567,18,67,6,19,284,"Adair County, Iowa",19,001,19001
11869.0,352.0,56.0,170.0,26,6415,5173,1652,888,872,16,3521,2629,2343,286,5173,60034,0.3968,40.1,5708,11889,10969,57,148,0,4,711,"Chickasaw County, Iowa",19,037,19037
9136.0,507.0,47.0,189.0,12,4512,3895,1155,631,602,29,2740,2085,1798,287,3895,54427,0.4158,39.8,4265,9190,8163,122,320,44,98,443,"Clarke County, Iowa",19,039,19039
16942.0,571.0,321.0,117.0,39,9078,8174,3013,1724,1605,119,5161,3705,3428,277,8174,59969,0.4371,39.8,13854,16959,16092,85,81,2,92,607,"Dickinson County, Iowa",19,059,19059
146545.0,7242.0,7013.0,2189.0,4685,82347,59134,11761,7283,6932,351,47373,34816,25463,9353,59134,62542,0.4918,36.4,63623,146956,124385,4941,9422,379,2974,4855,"Johnson County, Iowa",19,103,19103
10074.0,411.0,242.0,14.0,11,4798,4394,1519,848,797,51,2875,2181,1998,183,4394,52881,0.4512,39.1,4883,10074,9680,38,71,0,9,276,"Keokuk County, Iowa",19,107,19107
16779.0,804.0,92.0,14.0,31,8309,6767,2199,1325,1279,46,4568,3521,3153,368,6767,56037,0.4172,40.4,7794,16668,14941,324,307,19,165,912,"Tama County, Iowa",19,171,19171
34643.0,1508.0,454.0,214.0,102,15900,14481,4376,2482,2354,128,10105,7644,7066,578,14481,46246,0.445,39.1,16070,34814,30651,767,1382,187,342,1485,"Wapello County, Iowa",19,179,19179
10028.0,288.0,63.0,20.0,24,4919,4192,1383,914,888,26,2809,2291,2069,222,4192,56419,0.429,40.2,4856,10015,9161,10,253,3,65,523,"Franklin County, Iowa",19,069,19069
20091.0,562.0,202.0,42.0,5,10461,8726,2637,1463,1434,29,6089,4473,4247,226,8726,59212,0.4311,40.5,9492,19942,19253,134,159,2,2,392,"Carroll County, Iowa",19,027,19027
18248.0,584.0,262.0,20.0,39,9485,7391,2378,1318,1247,71,5013,3890,3573,317,7391,67795,0.3762,40.3,8181,18221,17625,90,112,20,0,374,"Cedar County, Iowa",19,031,19031
15563.0,391.0,110.0,32.0,28,7582,6903,2272,1212,1162,50,4631,3289,3041,248,6903,50406,0.4334,38.9,7580,15576,13802,389,65,0,65,1255,"Floyd County, Iowa",19,067,19067
8881.0,685.0,258.0,24.0,14,4481,3971,1442,801,754,47,2529,1972,1730,242,3971,53050,0.395,40.0,4544,8845,8477,103,49,0,11,205,"Greene County, Iowa",19,073,19073
11019.0,398.0,65.0,35.0,8,5571,4335,1416,813,753,60,2919,2391,2219,172,4335,56673,0.4373,40.5,5052,11044,9737,278,462,19,249,299,"Louisa County, Iowa",19,115,19115
11601.0,221.0,126.0,16.0,5,5959,4548,1390,818,780,38,3158,2694,2573,121,4548,64982,0.3649,41.4,5039,11614,11017,44,31,3,117,402,"Lyon County, Iowa",19,119,19119
23086.0,1145.0,843.0,9.0,50,8323,9743,4986,3449,3251,198,4757,3825,3706,119,9743,50021,0.4685,38.9,14659,22725,19504,235,89,3,325,2569,"Union County, Georgia",13,291,13291
33040.0,958.0,178.0,103.0,24,12686,13636,5076,3105,2946,159,8560,6059,5745,314,13636,36173,0.5101,39.0,17932,33117,28272,167,401,81,649,3547,"Bladen County, North Carolina",37,017,37017
68550.0,3021.0,2339.0,165.0,156,30621,29755,11992,7401,6915,486,17763,13622,12337,1285,29755,57194,0.4616,38.4,50219,67596,59048,972,482,100,586,6408,"Carteret County, North Carolina",37,031,37031
19239.0,807.0,135.0,95.0,64,7196,7909,3148,1584,1432,152,4761,3447,3301,146,7909,35527,0.5274,38.7,9812,18105,15783,57,115,0,33,2117,"Bertie County, North Carolina",37,015,37015
22493.0,902.0,168.0,10.0,12,9333,9378,3763,2385,2270,115,5615,4335,3925,410,9378,40090,0.4765,38.9,11584,22698,20128,152,138,7,178,2095,"Martin County, North Carolina",37,117,37117
13298.0,329.0,225.0,0.0,0,5248,5936,2456,1639,1521,118,3480,2637,2502,135,5936,47162,0.4413,39.9,7155,13274,11511,155,98,0,25,1485,"Perquimans County, North Carolina",37,143,37143
90510.0,2324.0,1076.0,169.0,78,38494,37388,13031,7873,7627,246,24357,18134,17123,1011,37388,43579,0.4498,39.1,44113,89945,78966,782,1011,521,1132,7533,"Rockingham County, North Carolina",37,157,37157
10448.0,373.0,201.0,22.0,2,4591,3933,1340,925,925,0,2593,2264,2229,35,3933,64572,0.3848,39.7,4266,10396,9338,187,86,0,4,781,"Camden County, North Carolina",37,029,37029
216804.0,7862.0,5139.0,227.0,432,99536,83735,24848,15582,14840,742,58887,45703,41561,4142,83735,52835,0.4529,39.1,92873,217088,186822,4129,3877,793,2848,18619,"Gaston County, North Carolina",37,071,37071
96548.0,2806.0,3322.0,284.0,22,42434,39821,15597,9470,9133,337,24224,18285,16768,1517,39821,59963,0.4648,39.3,47273,93620,82206,1747,1285,345,1065,6972,"Moore County, North Carolina",37,125,37125
60844.0,2103.0,915.0,101.0,28,28221,23332,7924,5139,4909,230,15408,12387,11660,727,23332,52623,0.4205,39.3,27805,60203,52230,765,480,270,592,5866,"Stanly County, North Carolina",37,167,37167
17601.0,413.0,414.0,6.0,0,7242,7510,2835,1820,1771,49,4675,3616,3310,306,7510,42222,0.4367,39.2,11271,17589,15072,131,103,43,325,1915,"Yancey County, North Carolina",37,199,37199
70571.0,2936.0,1097.0,190.0,216,31637,29033,11544,7310,6751,559,17489,14109,13425,684,29033,67031,0.4833,39.7,32224,70728,58564,2220,1684,307,2349,5604,"Chatham County, North Carolina",37,037,37037
194446.0,7381.0,4303.0,531.0,200,92707,68968,17400,11417,11184,233,51568,41956,39303,2653,68968,59865,0.4231,39.4,75438,195340,164338,2917,4648,694,6799,15944,"Johnston County, North Carolina",37,101,37101
38895.0,1181.0,348.0,100.0,61,18252,15896,5325,3339,3199,140,10571,8056,7496,560,15896,51020,0.4322,39.6,18503,38957,35062,321,182,12,670,2710,"Person County, North Carolina",37,145,37145
26667.0,374.0,82.0,108.0,10,12229,11938,4526,2700,2591,109,7412,5801,5303,498,11938,40962,0.4441,38.4,17738,26597,22775,298,184,60,408,2872,"Ashe County, North Carolina",37,009,37009
56264.0,2198.0,699.0,126.0,156,22447,23148,8141,4366,4169,197,15007,11499,10694,805,23148,39402,0.4799,39.1,27607,55509,47535,615,402,156,1244,5557,"Lenoir County, North Carolina",37,107,37107
191300.0,6104.0,24043.0,2981.0,345,99236,64386,12233,7827,7393,434,52153,42304,38317,3987,64386,50278,0.4098,43.9,79281,157477,138778,3570,1796,163,1045,12125,"Onslow County, North Carolina",37,133,37133
65570.0,1881.0,1891.0,99.0,44,26394,26683,10077,5873,5441,432,16606,12329,11527,802,26683,42608,0.4672,39.3,34401,65610,56696,914,448,71,381,7100,"Rutherford County, North Carolina",37,161,37161
37086.0,1241.0,312.0,67.0,9,15878,15425,5176,3150,3088,62,10249,8133,7701,432,15425,44682,0.4352,39.9,17432,37326,32338,318,630,166,732,3142,"Yadkin County, North Carolina",37,197,37197
89402.0,3268.0,1212.0,272.0,152,38355,35156,12244,7656,7411,245,22912,17465,16169,1296,35156,44557,0.4569,38.6,41253,87554,73991,2039,957,191,1295,9081,"Burke County, North Carolina",37,023,37023
7931.0,305.0,292.0,7.0,14,4024,3383,1054,547,544,3,2329,1710,1572,138,3383,64453,0.3987,40.0,3846,7778,7259,36,61,21,34,367,"Traill County, North Dakota",38,097,38097
4856.0,171.0,132.0,17.0,17,2515,2119,638,382,371,11,1481,1074,961,113,2119,65492,0.4081,40.9,2654,4808,4490,35,65,0,17,201,"Dickey County, North Dakota",38,021,38021
67483.0,1490.0,3908.0,905.0,183,38628,28277,5992,3144,2999,145,22285,16169,13830,2339,28277,68871,0.413,41.1,32982,64190,57551,758,1791,57,479,3554,"Ward County, North Dakota",38,101,38101
6881.0,222.0,138.0,23.0,3,3381,3158,1131,672,659,13,2027,1459,1321,138,3158,64549,0.4384,40.8,3865,6770,6071,141,72,10,34,442,"Pembina County, North Dakota",38,067,38067
2513.0,174.0,49.0,6.0,0,1135,1073,428,231,229,2,645,484,457,27,1073,60164,0.4856,41.6,1480,2373,2148,7,21,4,0,193,"Hettinger County, North Dakota",38,041,38041
174462.0,4134.0,12219.0,988.0,790,102906,75843,14574,8136,7777,359,61269,43527,34643,8884,75843,64482,0.4654,38.6,81887,175452,154480,4452,6349,748,1495,7928,"Cass County, North Dakota",38,017,38017
3288.0,36.0,16.0,4.0,1,1465,1585,650,339,321,18,935,703,647,56,1585,55902,0.4502,44.6,2207,3256,3050,32,14,16,7,137,"Emmons County, North Dakota",38,029,38029
16056.0,729.0,974.0,28.0,0,8264,6777,1916,1074,1041,33,4861,3763,3242,521,6777,61371,0.4343,39.5,7737,16094,15407,98,39,3,0,547,"Richland County, North Dakota",38,077,38077
2268.0,51.0,33.0,0.0,0,1177,1035,378,190,186,4,657,465,442,23,1035,56681,0.4448,40.9,1429,2244,1988,0,27,0,16,213,"Adams County, North Dakota",38,001,38001
2255.0,93.0,28.0,0.0,0,1162,1062,385,206,187,19,677,499,459,40,1062,54868,0.4968,42.3,1327,2222,2085,0,7,0,0,130,"Eddy County, North Dakota",38,027,38027
8333.0,258.0,189.0,7.0,5,4252,3709,1065,630,626,4,2644,2071,1913,158,3709,82181,0.3881,40.3,4794,8329,7014,33,30,0,36,1216,"Mercer County, North Dakota",38,057,38057
5285.0,114.0,123.0,16.0,0,2773,2371,784,366,351,15,1587,1193,1083,110,2371,63903,0.4093,41.8,2681,5162,4790,73,123,0,0,176,"Ransom County, North Dakota",38,073,38073
4327.0,79.0,188.0,4.0,7,1231,1112,244,178,168,10,868,705,652,53,1112,38939,0.5093,40.4,1348,4331,2958,4,2,1,0,1366,"Sioux County, North Dakota",38,085,38085
1816.0,40.0,97.0,50.0,3,967,842,291,124,124,0,551,394,335,59,842,58690,0.429,45.1,1045,1786,1612,12,0,0,0,162,"Golden Valley County, North Dakota",38,033,38033
2205.0,81.0,4.0,60.0,4,1011,1058,373,204,191,13,685,472,416,56,1058,52300,0.484,43.6,1437,2192,1907,6,23,0,81,175,"Towner County, North Dakota",38,095,38095
2320.0,29.0,66.0,20.0,0,1104,1061,427,253,250,3,634,417,400,17,1061,62865,0.4865,43.1,1557,2244,1973,34,8,0,20,209,"Divide County, North Dakota",38,023,38023
3832.0,72.0,70.0,21.0,4,2030,1864,580,331,331,0,1284,938,830,108,1864,63073,0.3836,41.4,2130,3834,3564,52,71,4,10,133,"Sargent County, North Dakota",38,081,38081
22851.0,618.0,635.0,31.0,33,8645,9045,3039,1949,1863,86,6006,4588,4253,335,9045,44899,0.4696,38.6,11192,22872,21275,19,16,11,30,1521,"Meigs County, Ohio",39,105,39105
38507.0,2316.0,404.0,71.0,0,17769,15159,4797,2952,2858,94,10362,8293,7508,785,15159,60112,0.3758,39.8,16786,38367,36216,229,117,25,22,1758,"Champaign County, Ohio",39,021,39021
164851.0,10703.0,7015.0,1304.0,380,79141,65604,19279,12165,11683,482,46325,35117,31026,4091,65604,68720,0.4448,37.2,70344,162702,148494,4044,3328,91,402,6343,"Greene County, Ohio",39,057,39057
59589.0,560.0,1112.0,87.0,31,24197,23221,7744,4661,4518,143,15477,11720,10731,989,23221,45118,0.4538,37.6,27543,59601,55797,271,220,5,0,3308,"Lawrence County, Ohio",39,087,39087
14421.0,626.0,29.0,25.0,21,5661,6108,2076,1246,1167,79,4032,3077,2873,204,6108,42341,0.4436,39.0,7980,14451,13281,39,20,0,16,1095,"Morgan County, Ohio",39,115,39115
21719.0,701.0,139.0,57.0,22,11161,9081,2772,1710,1640,70,6309,5021,4492,529,9081,55767,0.4085,39.7,9949,21743,20442,150,68,34,128,921,"Wyandot County, Ohio",39,175,39175
73890.0,2277.0,1346.0,63.0,404,35413,31183,10922,6778,6341,437,20261,15022,13624,1398,31183,54226,0.466,38.7,37860,73870,69147,866,377,79,169,3232,"Erie County, Ohio",39,043,39043
44714.0,1227.0,594.0,109.0,48,21069,18677,5684,3501,3332,169,12993,10190,9364,826,18677,56754,0.4256,39.9,23410,44910,41656,277,263,31,59,2624,"Logan County, Ohio",39,091,39091
535467.0,15771.0,6766.0,1707.0,4001,262556,224726,67760,39304,37273,2031,156966,112313,99928,12385,224726,57181,0.4743,38.4,245989,535722,480919,13487,10870,674,3100,26672,"Summit County, Ohio",39,153,39153
7751.0,231.0,522.0,14.0,4,3119,3582,1685,932,918,14,1897,1241,1160,81,3582,39324,0.4323,41.9,4877,7778,6698,74,94,0,7,905,"Lemhi County, Idaho",16,059,16059
22957.0,616.0,1026.0,104.0,5,9697,8876,3064,1926,1800,126,5812,4527,4217,310,8876,50579,0.4412,41.1,9454,23106,19214,474,519,61,624,2214,"Payette County, Idaho",16,075,16075
9040.0,346.0,282.0,7.0,23,3409,3418,1348,998,893,105,2070,1560,1415,145,3418,47556,0.4029,40.3,4733,9056,7931,61,30,0,13,1021,"Benewah County, Idaho",16,009,16009
43212.0,798.0,2639.0,71.0,180,17787,17537,7007,4803,4534,269,10530,8046,7450,596,17537,50256,0.4436,36.7,25121,43326,37965,515,393,37,87,4329,"Bonner County, Idaho",16,017,16017
892.0,41.0,66.0,0.0,0,409,290,107,66,66,0,183,126,124,2,290,46154,0.343,48.2,562,913,573,22,40,7,233,38,"Clark County, Idaho",16,033,16033
4140.0,235.0,53.0,2.0,18,1433,1774,865,581,581,0,909,554,531,23,1774,40875,0.4454,40.0,3277,4150,3761,7,2,0,16,364,"Custer County, Idaho",16,037,16037
26392.0,739.0,1775.0,534.0,43,11942,10606,2601,1712,1609,103,8005,6211,5441,770,10606,46855,0.3976,41.6,12489,23992,19159,953,576,209,758,2337,"Elmore County, Idaho",16,039,16039
12915.0,730.0,346.0,131.0,36,5279,4347,1472,1098,1086,12,2875,2583,2493,90,4347,58065,0.4028,39.9,8983,12468,10663,104,204,57,398,1042,"Fremont County, Idaho",16,043,16043
38027.0,1800.0,4533.0,733.0,123,17893,11016,1638,1084,1058,26,9378,8629,8019,610,11016,39160,0.4795,31.9,14227,38903,35029,619,944,13,211,2087,"Madison County, Idaho",16,065,16065
12411.0,505.0,531.0,39.0,21,4907,5466,2041,1222,1132,90,3425,2579,2341,238,5466,39386,0.4429,38.9,7129,12458,10472,56,74,14,0,1842,"Shoshone County, Idaho",16,079,16079
16269.0,956.0,393.0,15.0,30,6039,6407,2900,1933,1766,167,3507,2721,2588,133,6407,41516,0.4286,39.3,8772,15831,13953,120,35,29,19,1675,"Idaho County, Idaho",16,049,16049
11290.0,280.0,962.0,141.0,45,5811,3707,780,463,392,71,2927,2358,2076,282,3707,74216,0.3995,40.2,5833,11426,10025,206,421,37,230,507,"Teton County, Idaho",16,081,16081
7604.0,359.0,236.0,42.0,0,3250,2633,743,555,548,7,1890,1290,1234,56,2633,48823,0.4024,42.9,3017,7622,5821,307,405,40,408,641,"Power County, Idaho",16,077,16077
9959.0,335.0,418.0,11.0,21,3961,4035,1626,1085,1025,60,2409,1819,1683,136,4035,40992,0.4444,39.6,4643,9961,8037,128,299,33,161,1303,"Washington County, Idaho",16,087,16087
17846.0,282.0,411.0,16.0,27,8030,7409,2768,1629,1555,74,4641,3584,3382,202,7409,52561,0.4286,40.5,9255,17784,17037,150,55,0,16,526,"Hancock County, Illinois",17,067,17067
262006.0,8374.0,5924.0,634.0,1859,125422,107659,31609,18333,17470,863,76050,58924,52516,6408,107659,60738,0.4416,38.1,119392,262150,243875,3290,1907,252,953,11873,"Madison County, Illinois",17,119,17119
49999.0,1933.0,469.0,37.0,139,24889,19676,4824,3046,2953,93,14852,11996,11063,933,19676,77350,0.3859,39.6,20923,50343,46792,986,702,127,146,1590,"Grundy County, Illinois",17,063,17063
109344.0,2685.0,1234.0,170.0,793,50062,39796,12133,7389,7076,313,27663,21192,19190,2002,39796,58902,0.4301,38.5,45562,108580,98946,2003,1975,266,1054,4336,"Kankakee County, Illinois",17,091,17091
15467.0,484.0,258.0,7.0,8,7441,6516,2214,1290,1220,70,4302,3388,3164,224,6516,59787,0.3801,39.9,7420,15373,14784,126,13,3,13,434,"Mercer County, Illinois",17,131,17131
919327.0,33523.0,14173.0,6213.0,35262,482644,342791,96107,61051,59120,1931,246684,195900,180040,15860,342791,92809,0.454,38.7,360307,923090,720853,98632,54828,5316,18264,25197,"DuPage County, Illinois",17,043,17043
6164.0,135.0,116.0,0.0,54,2057,2154,832,491,475,16,1322,937,882,55,2154,36806,0.4413,39.3,3971,6181,5691,11,5,0,0,474,"Alexander County, Illinois",17,003,17003
12138.0,506.0,101.0,2.0,0,6180,5188,1640,1026,976,50,3548,2903,2767,136,5188,74684,0.4,39.2,5730,12141,11746,67,11,0,8,309,"Menard County, Illinois",17,129,17129
108654.0,3843.0,1167.0,68.0,69,50760,45095,14071,8076,7677,399,31024,23552,21640,1912,45095,58142,0.4314,38.7,50151,106541,98662,1738,1574,79,548,3940,"LaSalle County, Illinois",17,099,17099
5135658.0,46946.0,80880.0,37549.0,480559,2517713,1972108,538123,313880,299491,14389,1433985,1010754,883781,126973,1972108,64660,0.5081,38.8,2193338,5151562,3830519,509507,358386,44998,182551,225601,"Cook County, Illinois",17,031,17031
104377.0,2703.0,1502.0,248.0,620,45703,43912,14091,7831,7492,339,29821,20463,18610,1853,43912,50480,0.4746,38.3,50392,103150,96663,1151,735,10,197,4394,"Macon County, Illinois",17,115,17115
44697.0,971.0,649.0,76.0,181,20654,19739,6868,3857,3706,151,12871,9619,8926,693,19739,48805,0.4363,38.8,21965,44337,40950,610,233,57,219,2268,"Stephenson County, Illinois",17,177,17177
16196.0,483.0,197.0,30.0,39,7291,7051,2545,1417,1390,27,4506,3394,3139,255,7051,50251,0.4049,40.1,7986,16355,14903,37,57,0,30,1328,"Wayne County, Illinois",17,191,17191
38255.0,1685.0,444.0,22.0,51,18407,14499,4436,2880,2850,30,10063,8149,7641,508,14499,72808,0.4386,37.9,15542,38133,36131,402,81,2,5,1512,"Woodford County, Illinois",17,203,17203
38500.0,1756.0,618.0,42.0,104,15490,16235,5905,2938,2782,156,10330,7728,7079,649,16235,42769,0.4501,38.4,18659,38438,35797,151,66,50,55,2319,"Franklin County, Illinois",17,055,17055
30248.0,2232.0,877.0,168.0,183,13223,11408,3626,1809,1686,123,7782,5151,4227,924,11408,44471,0.4685,34.6,14426,30084,27715,414,654,36,12,1253,"McDonough County, Illinois",17,109,17109
304774.0,9647.0,4096.0,761.0,3992,161612,112453,30427,19794,19284,510,82026,69100,64096,5004,112453,86799,0.4028,39.2,118464,306363,267889,14920,7557,908,4927,10162,"McHenry County, Illinois",17,111,17111
1180.0,17.0,9.0,17.0,0,583,519,163,98,94,4,356,258,244,14,519,54112,0.3982,44.2,633,1154,1002,55,33,0,40,24,"Greeley County, Kansas",20,071,20071
28473.0,1909.0,1199.0,156.0,45,15920,11544,3068,1522,1513,9,8476,6084,4986,1098,11544,52883,0.484,38.1,13254,28547,25817,331,400,12,34,1953,"Ellis County, Kansas",20,051,20051
9578.0,256.0,185.0,3.0,8,4260,4497,1611,988,936,52,2886,2194,2049,145,4497,48778,0.4575,41.6,5616,9612,8588,24,5,0,8,987,"Linn County, Kansas",20,107,20107
21874.0,452.0,562.0,82.0,30,10768,7321,1500,902,886,16,5821,4713,4345,368,7321,49291,0.4053,40.2,8240,22151,13403,1973,2552,373,1950,1900,"Seward County, Kansas",20,175,20175
585041.0,12545.0,24520.0,3226.0,889,317344,228592,57261,35797,34620,1177,171331,133399,121515,11884,228592,89087,0.4465,39.5,241767,587461,512886,22629,17424,1954,10112,22456,"Johnson County, Kansas",20,091,20091
33013.0,1562.0,307.0,67.0,20,16539,12835,3928,2471,2379,92,8907,7169,6760,409,12835,71995,0.4247,40.6,13719,32744,30592,131,88,30,139,1764,"Miami County, Kansas",20,121,20121
3121.0,144.0,31.0,0.0,0,1329,1434,600,331,325,6,834,630,541,89,1434,39643,0.439,39.7,2021,3149,2732,5,0,0,0,412,"Woodson County, Kansas",20,207,20207
2817.0,55.0,26.0,2.0,1,1364,1269,479,243,243,0,790,647,598,49,1269,56492,0.4699,41.6,1712,2831,2514,41,52,22,89,113,"Ness County, Kansas",20,135,20135
14360.0,192.0,457.0,5.0,0,6360,5636,1936,1057,1024,33,3700,3005,2767,238,5636,43917,0.4397,38.9,7114,14383,12684,149,18,27,0,1505,"Bourbon County, Kansas",20,011,20011
2489.0,66.0,37.0,8.0,2,1198,985,355,212,195,17,630,470,449,21,985,53274,0.3958,38.8,1232,2439,2147,29,12,5,53,193,"Kiowa County, Kansas",20,097,20097
175766.0,5962.0,2870.0,482.0,986,84719,72267,21826,12103,11537,566,50441,36264,32701,3563,72267,56762,0.442,38.7,80012,174349,157232,2550,2736,400,1427,10004,"Shawnee County, Kansas",20,177,20177
3281.0,153.0,16.0,0.0,0,1355,1456,601,331,318,13,855,634,582,52,1456,40298,0.4374,40.5,2148,3272,2830,12,11,0,0,419,"Chautauqua County, Kansas",20,019,20019
62072.0,3042.0,1076.0,198.0,81,29045,25014,8222,4813,4606,207,16792,12373,10935,1438,25014,49936,0.4402,39.0,28495,60274,53522,402,700,67,429,5154,"Reno County, Kansas",20,155,20155
7572.0,246.0,518.0,3.0,5,3825,3046,994,538,531,7,2052,1563,1366,197,3046,49703,0.4324,39.2,3583,7568,6806,17,42,0,0,703,"Doniphan County, Kansas",20,043,20043
3963.0,98.0,115.0,36.0,0,1876,1320,385,239,231,8,935,815,768,47,1320,55064,0.4562,44.9,1686,3954,2800,211,244,58,227,414,"Haskell County, Kansas",20,081,20081
4817.0,432.0,48.0,0.0,7,2477,1967,532,403,403,0,1435,1085,957,128,1967,65417,0.3592,45.1,2163,4807,4283,92,171,55,53,153,"Scott County, Kansas",20,171,20171
9501.0,197.0,252.0,11.0,2,4524,3872,1311,859,839,20,2561,1883,1739,144,3872,48333,0.4202,39.5,4751,9535,8783,13,56,7,2,674,"Brown County, Kansas",20,013,20013
5255.0,110.0,76.0,2.0,0,2562,2316,828,482,459,23,1488,1142,1021,121,2316,50093,0.4144,41.1,3091,5245,4857,28,56,0,7,297,"Phillips County, Kansas",20,147,20147
2841.0,113.0,167.0,0.0,0,1381,1442,543,265,263,2,899,599,518,81,1442,48125,0.4228,41.6,1789,2794,2495,18,0,0,69,212,"Decatur County, Kansas",20,039,20039
17212.0,778.0,177.0,28.0,5,7231,6706,2130,1453,1379,74,4576,3827,3565,262,6706,52631,0.4339,39.4,7491,17342,15985,153,45,49,106,1004,"Garrard County, Kentucky",21,079,21079
91884.0,3176.0,3006.0,348.0,828,46323,36746,10127,5916,5725,191,26619,19770,17580,2190,36746,63050,0.4625,38.0,40312,91367,86289,941,792,34,236,3075,"Campbell County, Kentucky",21,037,21037
7461.0,805.0,170.0,0.0,8,1662,2523,910,688,673,15,1613,1292,1252,40,2523,32306,0.4535,41.0,3448,5971,5651,13,0,0,0,307,"Elliott County, Kentucky",21,063,21063
13998.0,455.0,246.0,18.0,0,6244,5741,1775,1141,1058,83,3966,3122,2824,298,5741,47643,0.4455,37.9,6382,13912,13123,65,136,0,109,479,"Larue County, Kentucky",21,123,21123
21318.0,1435.0,225.0,87.0,14,9436,8556,2782,1730,1679,51,5774,4541,4243,298,8556,55093,0.4233,39.4,10147,21412,19746,93,236,5,124,1208,"Mercer County, Kentucky",21,167,21167
17640.0,487.0,205.0,17.0,39,6675,6922,2353,1391,1305,86,4569,3443,3217,226,6922,38390,0.4391,38.3,10121,17569,16079,60,55,110,248,1017,"Russell County, Kentucky",21,207,21207
11940.0,574.0,137.0,5.0,15,5732,4581,1343,875,843,32,3238,2607,2366,241,4581,53743,0.4192,40.4,5185,11896,10941,35,97,47,101,675,"Washington County, Kentucky",21,229,21229
43136.0,1961.0,594.0,24.0,37,18135,16931,4971,3093,2892,201,11960,9342,8483,859,16931,41459,0.4392,40.0,19682,43167,39868,199,204,7,441,2448,"Barren County, Kentucky",21,009,21009
8616.0,266.0,112.0,4.0,15,3643,3311,992,726,679,47,2319,1897,1819,78,3311,57217,0.3625,40.8,3746,8652,8319,41,36,0,8,248,"Hancock County, Kentucky",21,091,21091
107217.0,4678.0,6184.0,878.0,162,49732,41646,10479,6536,6319,217,31167,23905,22088,1817,41646,54367,0.4354,40.2,46677,104255,95896,2437,1104,40,348,4430,"Hardin County, Kentucky",21,093,21093
9185.0,446.0,84.0,5.0,0,3622,3809,1252,778,761,17,2557,2055,1992,63,3809,51861,0.4274,40.4,4286,9192,8554,28,14,0,24,572,"McLean County, Kentucky",21,149,21149
12194.0,848.0,103.0,0.0,8,4779,4770,1379,822,822,0,3391,2778,2648,130,4770,37469,0.4461,39.9,5683,12040,11352,95,39,0,49,505,"Powell County, Kentucky",21,197,21197
12527.0,307.0,216.0,4.0,14,5118,5163,1839,1103,1074,29,3324,2690,2475,215,5163,44775,0.5242,40.7,6291,12587,11617,65,0,72,103,730,"Caldwell County, Kentucky",21,033,21033
47215.0,1260.0,1735.0,107.0,46,17962,18210,6185,3965,3894,71,12025,9212,8359,853,18210,48308,0.4856,38.3,21674,45933,42729,221,234,27,24,2698,"Boyd County, Kentucky",21,019,21019
316966.0,14189.0,12807.0,2795.0,3129,163926,129784,29653,17453,16571,882,100131,71321,58190,13131,129784,57291,0.4926,38.0,141653,315851,272097,8309,13922,865,7752,12906,"Fayette County, Kentucky",21,067,21067
22348.0,877.0,319.0,78.0,16,6673,8488,2739,1713,1694,19,5749,4256,4013,243,8488,37055,0.5063,40.1,10630,22092,20852,96,168,0,0,976,"Johnson County, Kentucky",21,115,21115
13208.0,495.0,80.0,13.0,9,3582,4865,1632,949,882,67,3233,2576,2386,190,4865,36134,0.4734,39.6,5961,11639,10891,9,78,0,13,648,"Morgan County, Kentucky",21,175,21175
63524.0,1811.0,1106.0,66.0,64,25175,25301,8136,5126,4706,420,17165,13176,12065,1111,25301,39998,0.5151,38.9,31487,63588,58801,517,454,15,304,3497,"Pulaski County, Kentucky",21,199,21199
19146.0,812.0,406.0,38.0,0,7702,6977,2450,1524,1493,31,4527,3438,3347,91,6977,38021,0.4777,37.4,8609,18949,17627,68,237,0,6,1011,"Adair County, Kentucky",21,001,21001
12768.0,353.0,280.0,20.0,0,3795,5358,1614,1071,1064,7,3744,2693,2525,168,5358,27344,0.534,38.1,6358,12843,12209,33,24,10,0,567,"Breathitt County, Kentucky",21,025,21025
18549.0,702.0,179.0,36.0,17,7138,7351,2281,1188,1099,89,5070,3853,3680,173,7351,38396,0.4715,38.8,9077,18466,17063,43,85,19,14,1242,"Hart County, Kentucky",21,099,21099
8459.0,313.0,293.0,4.0,0,3673,3498,1071,675,664,11,2427,1778,1626,152,3498,53056,0.4607,40.5,3993,8513,7906,50,74,0,11,472,"Trimble County, Kentucky",21,223,21223
4493.0,49.0,67.0,0.0,0,1572,1798,701,411,382,29,1097,765,691,74,1798,42929,0.5079,37.8,2358,4368,4110,50,5,0,0,203,"Hickman County, Kentucky",21,105,21105
8228.0,545.0,208.0,30.0,0,2850,3333,1509,943,915,28,1824,1273,1109,164,3333,52528,0.4355,37.1,4885,6985,6492,50,23,0,57,363,"Lyon County, Kentucky",21,143,21143
13213.0,292.0,221.0,0.0,7,4191,5268,1757,1080,1050,30,3511,2636,2511,125,5268,31147,0.5015,40.7,6568,13274,12571,8,19,0,0,676,"Lewis County, Kentucky",21,135,21135
26050.0,1377.0,305.0,174.0,27,12692,10355,3271,2269,2224,45,7084,5575,5071,504,10355,63820,0.4298,39.7,11138,26199,24070,161,658,0,387,923,"Woodford County, Kentucky",21,239,21239
10093.0,378.0,12.0,21.0,0,2908,4076,1404,931,868,63,2672,2022,1959,63,4076,31627,0.4562,40.2,5396,9971,9499,19,6,0,0,447,"Leslie County, Kentucky",21,131,21131
15488.0,115.0,363.0,0.0,17,4563,5784,1986,1239,1211,28,3798,2842,2735,107,5784,32798,0.4989,39.4,7435,15567,14189,7,29,0,17,1325,"Lawrence County, Kentucky",21,127,21127
64304.0,1326.0,1480.0,109.0,129,28532,27854,9054,4723,4527,196,18800,13133,11714,1419,27854,46080,0.5257,38.5,32065,64024,59390,447,280,135,121,3651,"McCracken County, Kentucky",21,145,21145
5137.0,184.0,133.0,11.0,63,2889,2231,631,355,348,7,1600,1210,1093,117,2231,57196,0.4769,43.0,2572,5086,4687,32,20,0,0,347,"Brule County, South Dakota",46,015,46015
4138.0,96.0,142.0,12.0,0,1969,1840,710,368,338,30,1130,817,781,36,1840,43438,0.4588,41.8,2543,4137,3713,13,4,39,0,368,"Gregory County, South Dakota",46,053,46053
186071.0,7297.0,5152.0,1586.0,731,103248,76819,17508,9757,9263,494,59311,43434,38342,5092,76819,61772,0.4166,39.2,81751,185832,159915,4751,6287,877,2207,11795,"Minnehaha County, South Dakota",46,099,46099
3624.0,170.0,9.0,24.0,0,1691,1546,536,304,285,19,1010,740,655,85,1546,48980,0.5155,43.7,1823,3623,3338,9,32,6,23,215,"Clark County, South Dakota",46,025,46025
4882.0,270.0,79.0,6.0,6,2644,2279,739,445,438,7,1540,1109,982,127,2279,61699,0.4331,42.8,2770,4855,4633,8,9,0,1,204,"Kingsbury County, South Dakota",46,077,46077
13740.0,1556.0,1172.0,104.0,65,7323,5233,1036,654,634,20,4197,3001,2082,919,5233,50724,0.5001,34.7,6039,13765,12447,85,372,45,91,725,"Clay County, South Dakota",46,027,46027
5708.0,51.0,28.0,4.0,4,2042,1651,428,265,255,10,1223,992,939,53,1651,47475,0.4525,39.0,2025,5788,4191,3,7,0,0,1587,"Dewey County, South Dakota",46,041,46041
17447.0,1227.0,475.0,0.0,88,9277,7460,2065,1159,1142,17,5395,3630,3273,357,7460,64783,0.3997,40.4,8034,16622,15417,29,62,0,88,1026,"Hughes County, South Dakota",46,065,46065
2352.0,82.0,30.0,0.0,0,1293,1010,297,201,194,7,713,556,517,39,1010,56875,0.4412,42.4,1215,2329,2145,12,9,0,6,157,"Sanborn County, South Dakota",46,111,46111
3211.0,56.0,71.0,5.0,6,1740,1508,550,309,296,13,958,738,680,58,1508,54155,0.4376,45.0,1832,3203,3038,0,19,0,0,146,"Hand County, South Dakota",46,059,46059
22386.0,920.0,1014.0,95.0,111,11254,9445,2545,1647,1582,65,6900,4957,4340,617,9445,58342,0.457,39.7,10110,21388,19597,207,122,0,97,1365,"Yankton County, South Dakota",46,135,46135
18003.0,580.0,180.0,24.0,123,8933,7557,2209,1046,1038,8,5348,3890,3552,338,7557,52313,0.4188,40.3,8500,18036,14760,644,1303,55,535,739,"Beadle County, South Dakota",46,005,46005
19606.0,1608.0,519.0,46.0,188,10493,8660,2448,1374,1343,31,6212,4398,3922,476,8660,50570,0.4654,40.4,9503,19545,17972,151,212,11,3,1196,"Davison County, South Dakota",46,035,46035
2005.0,51.0,29.0,0.0,11,925,921,385,245,233,12,536,383,339,44,921,49632,0.5526,42.5,1092,1975,1798,13,19,0,14,131,"Jerauld County, South Dakota",46,073,46073
2996.0,238.0,54.0,2.0,25,1724,1344,452,354,354,0,892,682,619,63,1344,71382,0.4557,40.4,1509,2997,2863,21,0,0,0,113,"Stanley County, South Dakota",46,117,46117
2293.0,47.0,10.0,0.0,0,1123,982,378,241,241,0,604,415,388,27,982,54583,0.4336,43.9,1607,2231,2002,33,29,0,0,167,"Potter County, South Dakota",46,107,46107
9167.0,275.0,108.0,0.0,28,3817,3166,1124,635,604,31,2042,1566,1483,83,3166,50481,0.4368,40.1,3910,9076,7317,30,2,4,5,1718,"Charles Mix County, South Dakota",46,023,46023
4780.0,136.0,89.0,10.0,13,2452,1873,674,387,366,21,1199,934,863,71,1873,63723,0.3932,41.6,2637,4827,4327,12,102,0,45,341,"Marshall County, South Dakota",46,091,46091
2869.0,85.0,44.0,0.0,24,1596,1284,461,245,232,13,823,633,589,44,1284,57981,0.4452,42.3,1777,2854,2581,9,11,0,0,253,"Perkins County, South Dakota",46,105,46105
35589.0,1799.0,903.0,95.0,20,12551,12620,3605,2413,2269,144,9015,7277,6768,509,12620,39005,0.4975,37.8,15452,35504,33217,103,198,0,40,1946,"Whitley County, Kentucky",21,235,21235
36115.0,1123.0,612.0,6.0,34,10359,15000,4660,2923,2807,116,10340,8120,7518,602,15000,32730,0.5145,38.9,18505,35979,34145,70,45,20,48,1651,"Floyd County, Kentucky",21,071,21071
163358.0,6800.0,5606.0,454.0,1801,83680,63966,16284,9755,9214,541,47682,35063,31021,4042,63966,64339,0.4427,38.7,69661,164337,151706,1854,1572,247,1736,7222,"Kenton County, Kentucky",21,117,21117
12372.0,487.0,104.0,13.0,17,3254,5020,1449,889,885,4,3571,2685,2628,57,5020,28147,0.5039,40.0,6070,12362,11788,0,0,0,13,561,"Magoffin County, Kentucky",21,153,21153
24118.0,2226.0,452.0,23.0,111,10014,8623,2433,1420,1355,65,6190,4745,3738,1007,8623,38230,0.4943,36.0,10335,24270,22536,214,224,54,82,1160,"Rowan County, Kentucky",21,205,21205
25335.0,1956.0,372.0,87.0,0,10853,9857,3186,1875,1802,73,6671,5373,4822,551,9857,44522,0.4764,38.7,11004,25165,23777,108,259,0,76,945,"Taylor County, Kentucky",21,217,21217
4752.0,84.0,4.0,0.0,8,1831,1980,719,415,353,62,1261,995,964,31,1980,45109,0.5426,39.4,2476,4725,4397,52,7,0,0,269,"Carlisle County, Kentucky",21,039,21039
14065.0,1033.0,56.0,0.0,0,4781,5499,1940,1157,1125,32,3559,2640,2474,166,5499,31688,0.4613,38.1,6927,14101,13180,0,2,0,2,917,"Estill County, Kentucky",21,065,21065
129237.0,4234.0,2503.0,138.0,983,53995,48488,14563,8634,8366,268,33925,26069,24169,1900,48488,47269,0.4839,40.2,58153,128068,112822,1583,992,121,777,11773,"Rapides Parish, Louisiana",22,079,22079
130190.0,6075.0,1490.0,167.0,177,56916,47597,13105,8096,7954,142,34492,26379,23842,2537,47597,47832,0.4695,39.6,55325,131166,117216,893,493,199,1058,11307,"Tangipahoa Parish, Louisiana",22,105,22105
10896.0,159.0,79.0,10.0,0,3706,4084,1419,750,736,14,2665,2083,1957,126,4084,38500,0.4941,42.4,5158,10625,9025,115,25,2,15,1443,"West Carroll Parish, Louisiana",22,123,22123
9919.0,363.0,98.0,13.0,0,3295,3665,1255,832,791,41,2410,1931,1743,188,3665,37691,0.5352,40.8,5208,9542,8259,52,2,0,187,1042,"Caldwell Parish, Louisiana",22,021,22021
7041.0,1506.0,152.0,16.0,0,1332,2037,749,375,375,0,1288,924,818,106,2037,22346,0.707,41.8,2889,4422,4007,4,14,0,0,397,"East Carroll Parish, Louisiana",22,035,22035
33139.0,1382.0,197.0,262.0,90,11419,12172,3556,1873,1820,53,8616,6307,5919,388,12172,31965,0.4904,40.7,15055,32001,28195,49,37,0,41,3679,"Evangeline Parish, Louisiana",22,039,22039
45838.0,1967.0,592.0,183.0,203,18530,15005,3537,2405,2307,98,11468,8696,7957,739,15005,44661,0.444,39.5,17035,45973,39252,922,669,194,638,4298,"St. Bernard Parish, Louisiana",22,087,22087
25709.0,1388.0,406.0,0.0,10,12285,9643,2437,1779,1729,50,7206,5840,5465,375,9643,65385,0.4104,39.7,10977,25266,23118,49,25,0,152,1922,"West Baton Rouge Parish, Louisiana",22,121,22121
8482.0,317.0,10.0,13.0,0,3166,3372,1100,565,563,2,2272,1537,1421,116,3372,33816,0.5533,39.5,4216,8413,7485,0,9,0,0,919,"Red River Parish, Louisiana",22,081,22081
38246.0,1459.0,1295.0,84.0,78,11941,14659,4293,2450,2410,40,10366,6431,5128,1303,14659,28567,0.5484,38.4,19133,38011,33303,378,114,7,89,4120,"Natchitoches Parish, Louisiana",22,069,22069
9678.0,938.0,47.0,8.0,0,3215,3364,1124,615,615,0,2240,1838,1806,32,3364,40129,0.4891,43.8,5007,8488,7521,23,20,0,0,924,"Catahoula Parish, Louisiana",22,025,22025
20022.0,617.0,72.0,0.0,48,6566,7423,2496,1406,1389,17,4927,3897,3741,156,7423,35282,0.4937,42.0,9311,19057,17091,19,20,0,33,1894,"Franklin Parish, Louisiana",22,041,22041
22243.0,614.0,110.0,13.0,95,9128,8552,2801,1743,1718,25,5751,4063,3766,297,8552,43759,0.4883,40.7,10805,22254,20284,15,83,88,74,1710,"Assumption Parish, Louisiana",22,007,22007
58975.0,1972.0,990.0,30.0,13,23828,22086,6290,4121,3799,322,15796,12591,11344,1247,22086,51945,0.443,43.6,26586,59363,52851,562,473,46,475,4956,"Vermilion Parish, Louisiana",22,113,22113
19555.0,983.0,374.0,218.0,6,6355,7162,2544,1558,1546,12,4618,3223,3016,207,7162,32500,0.5062,40.5,9611,17764,15218,57,38,0,0,2451,"Concordia Parish, Louisiana",22,029,22029
56983.0,1829.0,1124.0,121.0,81,25490,21338,7779,4920,4530,390,13559,10417,9476,941,21338,49204,0.4201,37.9,36942,57212,51413,442,344,4,50,4959,"Oxford County, Maine",23,017,23017
150345.0,4851.0,4325.0,448.0,301,71300,62156,18942,11206,10266,940,43214,32468,27476,4992,62156,50808,0.4537,37.8,75789,150105,132865,2233,1775,88,274,12870,"Penobscot County, Maine",23,019,23019
106273.0,4052.0,2012.0,372.0,80,53112,45630,13404,7901,7428,473,32226,24457,20605,3852,45630,53509,0.4267,38.4,49892,106432,94692,1733,1467,297,271,7972,"Androscoggin County, Maine",23,001,23001
289758.0,6916.0,8671.0,1141.0,2046,160054,120644,36494,21553,19639,1914,84150,62824,52399,10425,120644,73072,0.4526,38.4,144470,288865,256151,9321,6727,636,916,15114,"Cumberland County, Maine",23,005,23005
202345.0,4180.0,7527.0,591.0,911,106639,85314,28406,17929,16802,1127,56908,44033,38111,5922,85314,67830,0.4253,38.9,110226,202277,182643,3734,2377,214,247,13062,"York County, Maine",23,031,23031
50164.0,1988.0,788.0,118.0,12,21399,21321,7553,4418,3960,458,13768,10984,9508,1476,21321,44256,0.4448,38.7,30868,49972,44488,461,341,21,22,4639,"Somerset County, Maine",23,025,23025
51341.0,1821.0,1051.0,115.0,587,23759,22089,9792,6114,5784,330,12297,9290,8115,1175,22089,63499,0.4719,38.5,56310,51044,46643,1088,807,65,288,2153,"Worcester County, Maryland",24,047,24047
36873.0,1263.0,1335.0,139.0,299,17533,16826,7096,4686,4417,269,9730,7314,6562,752,16826,73547,0.5161,39.7,20247,36739,33473,954,729,38,570,975,"Talbot County, Maryland",24,041,24041
212128.0,4584.0,3655.0,965.0,1526,103802,94323,44064,27321,25591,1730,50259,37815,33472,4343,94323,74336,0.4542,37.5,163557,211206,189245,9065,6017,455,1481,4943,"Barnstable County, Massachusetts",25,001,25001
125426.0,1391.0,3296.0,496.0,844,62726,54813,20461,11612,10754,858,34352,24528,21300,3228,54813,59230,0.4621,36.3,69079,124293,113694,4141,2678,350,479,2951,"Berkshire County, Massachusetts",25,003,25003
510033.0,15888.0,5468.0,2270.0,15428,261709,187460,63145,40588,38186,2402,124315,100286,93457,6829,187460,89489,0.4539,37.8,207003,508430,451094,29303,16829,787,1846,8571,"Plymouth County, Massachusetts",25,023,25023
693349.0,27925.0,14347.0,7553.0,53840,368739,265300,82356,50645,48261,2384,182944,143753,127684,16069,265300,103291,0.4766,38.6,278615,692118,555742,74759,48976,1282,2872,8487,"Norfolk County, Massachusetts",25,021,25021
11005.0,380.0,206.0,86.0,45,6231,3713,1171,733,670,63,2542,1860,1647,213,3713,107717,0.4936,38.9,12345,11114,9433,463,727,29,78,384,"Nantucket County, Massachusetts",25,019,25019
114866.0,3946.0,773.0,201.0,132,54724,43416,12558,8557,8049,508,30858,25419,23625,1794,43416,62965,0.403,38.9,51177,115272,106968,1324,1779,192,444,4565,"Allegan County, Michigan",26,005,26005
9092.0,937.0,138.0,10.0,41,3049,3007,1406,832,805,27,1601,1245,1135,110,3007,45570,0.4019,36.2,6691,8141,7411,30,27,0,2,671,"Alger County, Michigan",26,003,26003
26137.0,1477.0,382.0,61.0,60,10966,10156,3659,2450,2355,95,6497,5195,4896,299,10156,50104,0.4179,40.2,16157,26254,23157,202,541,28,751,1575,"Oceana County, Michigan",26,127,26127
30341.0,1794.0,538.0,33.0,81,10642,12199,4859,2896,2792,104,7340,5579,5093,486,12199,39565,0.4536,37.5,23387,30319,26541,243,94,7,21,3413,"Clare County, Michigan",26,035,26035
70133.0,8004.0,1361.0,467.0,328,32653,24739,5827,3540,3367,173,18912,14272,10647,3625,24739,45116,0.4905,34.9,29154,70160,62458,779,1061,92,335,5435,"Isabella County, Michigan",26,073,26073
52384.0,2329.0,507.0,48.0,45,22467,21777,7205,4495,4230,265,14572,11622,10734,888,21777,49988,0.4122,38.9,24447,52230,49160,187,153,43,56,2631,"Tuscola County, Michigan",26,157,26157
28272.0,1005.0,187.0,95.0,101,12375,12752,4471,2724,2594,130,8281,5876,5069,807,12752,43363,0.439,37.7,16056,28172,26375,164,123,20,32,1458,"Alpena County, Michigan",26,007,26007
82355.0,2906.0,1399.0,532.0,335,37576,34199,9964,6146,5911,235,24235,18878,17191,1687,34199,62625,0.4728,38.0,36973,82737,75996,1235,1912,5,155,3434,"Midland County, Michigan",26,111,26111
8158.0,373.0,73.0,8.0,3,2745,3806,1626,968,872,96,2180,1608,1459,149,3806,42335,0.4439,38.1,9226,8202,7019,51,32,0,7,1093,"Oscoda County, Michigan",26,135,26135
77528.0,3931.0,1228.0,194.0,352,38019,29728,8692,5591,5372,219,21036,16943,15379,1564,29728,70390,0.4193,38.0,31736,77840,72425,1114,1063,29,186,3023,"Clinton County, Michigan",26,037,26037
40598.0,2583.0,309.0,96.0,66,16092,15035,4809,2738,2593,145,10226,8012,7300,712,15035,47848,0.4555,38.3,16330,36619,34600,216,164,7,44,1588,"Gratiot County, Michigan",26,057,26057
97374.0,4339.0,1419.0,255.0,150,43688,38345,12167,7597,7284,313,26178,19462,17925,1537,38345,55450,0.417,38.4,43806,95105,88009,850,839,25,530,4852,"Lenawee County, Michigan",26,091,26091
62704.0,3308.0,566.0,109.0,55,26904,23913,7512,4816,4514,302,16401,13025,12020,1005,23913,49448,0.4178,38.6,28598,60929,55706,418,181,14,198,4412,"Montcalm County, Michigan",26,117,26117
157650.0,4864.0,1953.0,194.0,482,71517,64850,20531,12821,12061,760,44319,33901,30808,3093,64850,56951,0.4342,38.9,72179,157967,146658,2268,1341,105,212,7383,"St. Clair County, Michigan",26,147,26147
363721.0,19786.0,14653.0,5932.0,9543,185365,141245,34662,21387,20406,981,106583,77983,61050,16933,141245,72586,0.4848,36.7,151023,362262,306123,20369,23237,639,1479,10415,"Washtenaw County, Michigan",26,161,26161
51006.0,1878.0,1624.0,146.0,18,22993,21019,7308,4848,4664,184,13711,10778,9944,834,21019,55107,0.4544,39.6,26295,51401,47512,357,337,58,112,3025,"Cass County, Michigan",26,027,26027
23695.0,1404.0,439.0,47.0,73,7786,11139,5247,3198,3061,137,5892,4151,3743,408,11139,42054,0.4295,38.5,24538,23640,21723,223,107,4,4,1579,"Roscommon County, Michigan",26,143,26143
42975.0,1525.0,860.0,145.0,68,18277,16650,5365,3296,3129,167,11285,9002,8036,966,16650,51947,0.4143,39.7,20849,41346,35683,544,803,104,294,3918,"Branch County, Michigan",26,023,26023
157209.0,6899.0,2001.0,363.0,260,67818,61805,19133,11796,11379,417,42672,31632,28872,2760,61805,53658,0.4452,38.3,69580,150711,139357,1422,1231,29,215,8457,"Jackson County, Michigan",26,075,26075
860791.0,28108.0,7266.0,3273.0,3194,418295,346402,104263,62444,60081,2363,242139,182492,167167,15325,346402,62855,0.4246,39.0,366016,863583,732499,58617,27149,4945,6915,33458,"Macomb County, Michigan",26,099,26099
8351.0,534.0,111.0,2.0,2,2891,3107,1170,758,740,18,1937,1360,1225,135,3107,46065,0.4566,38.2,5301,7302,6823,53,25,3,0,398,"Baraga County, Michigan",26,013,26013
108168.0,7822.0,1066.0,620.0,441,52199,44480,13765,8541,8157,384,30715,22975,20599,2376,44480,64348,0.4141,38.5,47558,108742,99453,1925,2089,122,240,4913,"Eaton County, Michigan",26,045,26045
26094.0,929.0,333.0,60.0,0,10063,10154,3446,1858,1746,112,6708,4790,4354,436,10154,37640,0.4773,38.4,12155,25712,22325,187,154,43,130,2873,"Upson County, Georgia",13,293,13293
20158.0,1375.0,145.0,79.0,61,7259,7503,2652,1657,1609,48,4851,3938,3706,232,7503,38068,0.4593,38.6,9332,18532,16277,84,82,62,0,2027,"Washington County, Georgia",13,303,13303
29104.0,1948.0,277.0,23.0,14,12629,11695,4505,2947,2830,117,7190,6003,5751,252,11695,52493,0.4204,39.0,16254,29310,25482,420,166,20,57,3165,"White County, Georgia",13,311,13311
26942.0,1274.0,539.0,21.0,160,10445,10136,3312,1981,1937,44,6824,5080,4659,421,10136,46636,0.4976,37.7,11652,27013,22460,535,546,114,295,3063,"Peach County, Georgia",13,225,13225
157810.0,8268.0,2341.0,156.0,289,77096,53299,11982,8234,8039,195,41317,35315,33443,1872,53299,68370,0.3762,39.8,56654,158996,134214,3821,2630,867,1338,16126,"Paulding County, Georgia",13,223,13223
18970.0,346.0,109.0,16.0,22,7416,7048,2293,1625,1546,79,4755,3888,3773,115,7048,42804,0.4682,39.8,8167,19074,15835,84,138,11,220,2786,"Pierce County, Georgia",13,229,13229
18224.0,1131.0,93.0,19.0,13,7922,6143,1955,1201,1185,16,4188,3465,3340,125,6143,64878,0.4197,39.1,6992,18073,15497,105,104,73,34,2260,"Pike County, Georgia",13,231,13231
198836.0,6872.0,8401.0,1172.0,1668,86387,71400,19668,11205,10774,431,51732,36063,32571,3492,71400,42728,0.4738,39.3,88622,191532,160533,3597,2441,309,1053,23599,"Richmond County, Georgia",13,245,13245
13740.0,651.0,117.0,27.0,1,5376,5098,1793,1041,1007,34,3305,2561,2388,173,5098,39842,0.4607,41.4,6785,13591,11588,155,13,15,44,1776,"Screven County, Georgia",13,251,13251
25174.0,3771.0,357.0,29.0,8,7551,8241,2576,1612,1578,34,5665,4563,4297,266,8241,40730,0.4543,40.2,10026,19039,15942,217,223,6,651,2000,"Tattnall County, Georgia",13,267,13267
18971.0,838.0,237.0,21.0,13,7313,7367,2467,1464,1443,21,4900,3910,3612,298,7367,40415,0.4356,39.2,8798,18877,14278,128,191,13,243,4024,"Berrien County, Georgia",13,019,13019
28525.0,2029.0,313.0,50.0,49,11393,11522,4036,2202,2118,84,7486,5849,5350,499,11522,52748,0.4378,39.4,13123,25894,24789,96,75,27,8,899,"Montgomery County, Illinois",17,135,17135
55507.0,1489.0,835.0,146.0,113,25942,23084,7872,4495,4264,231,15212,11717,10699,1018,23084,54232,0.4345,38.2,25823,55135,51131,656,753,32,290,2273,"Whiteside County, Illinois",17,195,17195
65303.0,876.0,1058.0,86.0,198,32210,27112,8931,5194,5044,150,18181,13913,12562,1351,27112,52993,0.4503,39.4,30192,64844,60894,608,268,10,8,3056,"Adams County, Illinois",17,001,17001
37173.0,1256.0,448.0,93.0,196,18333,14353,4396,2402,2270,132,9957,8065,7313,752,14353,66639,0.4101,38.8,15882,35508,33666,252,252,1,87,1250,"Clinton County, Illinois",17,027,17027
103455.0,8027.0,1848.0,568.0,684,51708,38150,8598,5437,5210,227,29552,22305,17954,4351,38150,63317,0.4361,37.0,41206,103654,92576,2421,3192,96,1042,4327,"DeKalb County, Illinois",17,037,17037
6384.0,296.0,80.0,9.0,0,2890,2773,939,539,522,17,1834,1403,1281,122,2773,51080,0.4144,39.7,3201,6428,6001,12,14,0,0,401,"Edwards County, Illinois",17,047,17047
9478.0,263.0,12.0,29.0,0,4348,3711,1222,710,699,11,2489,1895,1724,171,3711,54256,0.4192,39.3,4349,9532,8863,8,31,0,51,579,"Jasper County, Illinois",17,079,17079
37454.0,1489.0,555.0,114.0,119,15713,14985,4640,2792,2652,140,10345,7658,7158,500,14985,49896,0.4516,38.6,16998,35639,32948,379,210,16,38,2048,"Jefferson County, Illinois",17,081,17081
76543.0,1516.0,693.0,128.0,219,31036,31151,10477,5885,5569,316,20674,15108,13846,1262,31151,46515,0.4506,38.5,36109,74983,69432,710,544,24,373,3900,"Vermilion County, Illinois",17,183,17183
681584.0,26046.0,5742.0,1862.0,13360,345127,229498,59610,40381,38815,1566,169888,140362,132412,7950,229498,86961,0.4068,38.5,243907,682082,578037,44136,25692,2768,11843,19606,"Will County, Illinois",17,197,17197
66429.0,2676.0,844.0,78.0,146,28589,27029,8910,4924,4795,129,18119,13472,12158,1314,27029,50734,0.4509,38.4,31286,65070,60738,416,471,142,94,3209,"Williamson County, Illinois",17,199,17199
15549.0,532.0,237.0,19.0,15,7399,6720,2056,1276,1246,30,4664,3916,3574,342,6720,56531,0.4221,38.8,7814,15505,14605,43,135,0,0,722,"Clark County, Illinois",17,023,17023
19306.0,634.0,167.0,29.0,0,9440,7613,2337,1368,1273,95,5276,4161,3788,373,7613,56714,0.424,38.8,8446,19464,16151,257,204,66,163,2623,"Douglas County, Illinois",17,041,17041
33787.0,1252.0,504.0,170.0,79,17053,13877,4078,2377,2226,151,9799,7478,6951,527,13877,56685,0.4544,38.7,14892,33733,31542,256,366,17,113,1439,"Effingham County, Illinois",17,049,17049
34895.0,1546.0,394.0,27.0,17,14829,13940,4914,2889,2775,114,9026,6667,6053,614,13940,51643,0.4538,38.4,16328,32562,30383,91,71,15,111,1891,"Fulton County, Illinois",17,057,17057
12985.0,594.0,141.0,4.0,7,6028,4949,1724,958,938,20,3225,2510,2334,176,4949,49885,0.4204,37.2,6438,12849,12035,22,34,0,9,749,"Greene County, Illinois",17,061,17061
8101.0,160.0,37.0,0.0,53,3458,3400,1231,701,617,84,2169,1873,1747,126,3400,54046,0.4165,40.1,4107,8100,7609,38,16,0,0,437,"Hamilton County, Illinois",17,065,17065
3907.0,117.0,49.0,0.0,38,1290,1363,579,401,388,13,784,566,541,25,1363,51250,0.5011,39.8,2181,3841,3519,10,0,0,0,312,"Hardin County, Illinois",17,069,17069
48726.0,1055.0,634.0,67.0,16,22836,19856,6834,3910,3810,100,13022,10271,9664,607,19856,59933,0.4151,38.6,22165,48549,45500,382,465,29,97,2076,"Henry County, Illinois",17,073,17073
12367.0,1533.0,63.0,9.0,0,3778,4303,1842,1199,1147,52,2461,2019,1895,124,4303,52774,0.4409,38.9,5625,10217,9754,44,10,23,6,380,"Johnson County, Illinois",17,087,17087
49846.0,1683.0,305.0,137.0,91,20906,20680,7548,3789,3497,292,13132,9376,8298,1078,20680,44129,0.4523,36.9,23917,47703,44033,287,1010,6,166,2201,"Knox County, Illinois",17,095,17095
35668.0,1442.0,211.0,41.0,30,15732,14307,4730,2741,2647,94,9577,7319,6799,520,14307,55160,0.4302,38.9,15919,33887,31757,223,333,10,103,1461,"Livingston County, Illinois",17,105,17105
4947.0,146.0,25.0,0.0,8,2275,1939,716,444,429,15,1223,991,954,37,1939,57118,0.3907,38.1,2450,4953,4774,24,22,0,0,133,"Scott County, Illinois",17,171,17171
131903.0,4817.0,1562.0,293.0,407,62011,54291,16689,9892,9577,315,37602,28757,26559,2198,54291,63454,0.4181,38.3,58847,130814,123818,1008,1012,6,268,4702,"Tazewell County, Illinois",17,179,17179
17005.0,712.0,437.0,46.0,56,7803,6862,2254,1326,1280,46,4608,3524,3278,246,6862,50310,0.412,37.5,7687,16952,15403,298,577,46,76,552,"Warren County, Illinois",17,187,17187
39449.0,1310.0,469.0,160.0,18,17280,14403,4538,2913,2750,163,9865,7938,7283,655,14403,57712,0.4253,38.6,17078,39616,36596,231,219,0,68,2502,"Harrison County, Indiana",18,061,18061
109040.0,5279.0,2570.0,77.0,515,46739,43039,13954,8137,7713,424,29085,22511,20299,2212,43039,53658,0.4402,38.9,49177,102327,91814,1898,707,191,688,7029,"LaPorte County, Indiana",18,091,18091
31064.0,1347.0,575.0,81.0,100,14341,12862,4232,2562,2476,86,8630,6647,6015,632,12862,54259,0.4019,38.1,14154,30377,27515,250,173,0,54,2385,"Wabash County, Indiana",18,169,18169
33006.0,1218.0,739.0,12.0,57,15084,12533,3967,2592,2531,61,8566,6744,6210,534,12533,63892,0.3774,39.1,13554,33106,30360,328,245,0,363,1810,"Jasper County, Indiana",18,073,18073
10128.0,293.0,163.0,12.0,0,4744,4187,1396,713,679,34,2791,2096,1834,262,4187,52726,0.4032,39.8,4814,9926,9257,14,6,0,0,649,"Martin County, Indiana",18,101,18101
167188.0,5395.0,4730.0,355.0,892,78202,64517,18452,12115,11635,480,46065,36049,32371,3678,64517,71152,0.4267,39.2,68720,166977,151997,3467,1745,130,659,8979,"Porter County, Indiana",18,127,18127
28048.0,975.0,311.0,89.0,46,13877,10992,3406,1889,1765,124,7586,6054,5721,333,10992,56332,0.428,38.9,12355,27900,25363,191,61,10,187,2088,"Ripley County, Indiana",18,137,18137
20228.0,480.0,303.0,7.0,13,9802,8127,2694,1700,1628,72,5433,4297,4053,244,8127,57305,0.4418,39.6,9095,20213,19098,147,121,5,50,792,"Spencer County, Indiana",18,147,18147
14931.0,891.0,117.0,50.0,48,7467,6376,2117,1253,1218,35,4259,3529,3130,399,6376,58118,0.4001,39.8,7011,14957,13669,63,129,0,0,1096,"Tipton County, Indiana",18,159,18159
106241.0,5850.0,2760.0,511.0,399,47738,41994,11989,6622,6207,415,30005,21772,18484,3288,41994,45230,0.4676,37.2,47215,103552,93337,982,1540,80,435,7178,"Vigo County, Indiana",18,167,18167
61757.0,2535.0,1522.0,91.0,102,31128,24514,7121,4724,4587,137,17393,14306,13244,1062,24514,73482,0.4409,40.2,25961,61555,56783,1122,769,0,396,2485,"Warrick County, Indiana",18,173,18173
42527.0,1656.0,480.0,47.0,4,21207,16801,4811,2968,2866,102,11990,9258,8686,572,16801,56421,0.4258,39.7,18045,42603,38762,296,214,68,40,3223,"DeKalb County, Indiana",18,033,18033
38690.0,1011.0,1027.0,110.0,34,16647,12325,3471,2435,2358,77,8854,7667,7172,495,12325,64498,0.3998,38.2,14790,39040,22688,121,261,31,244,15695,"LaGrange County, Indiana",18,087,18087
16525.0,679.0,69.0,10.0,13,7383,6667,2084,1224,1169,55,4583,3825,3542,283,6667,54346,0.406,41.4,7482,16452,14763,37,45,0,21,1586,"Rush County, Indiana",18,139,18139
64808.0,4150.0,1541.0,206.0,49,33529,25485,5832,3717,3546,171,19653,16133,14968,1165,25485,83077,0.4894,40.2,27050,64836,59191,1185,1518,55,187,2700,"Boone County, Indiana",18,011,18011
14914.0,492.0,274.0,21.0,39,5889,6744,2649,1380,1296,84,4095,2616,2312,304,6744,38839,0.4887,37.2,10781,13916,12687,99,54,0,8,1068,"Gogebic County, Michigan",26,053,26053
22770.0,1098.0,146.0,161.0,43,11477,9209,3017,1814,1715,99,6192,4843,4489,354,9209,63452,0.4215,39.4,10880,22788,21441,131,166,1,98,951,"Meeker County, Minnesota",27,093,27093
65618.0,3816.0,1659.0,481.0,101,33362,23005,6886,4008,3872,136,16119,12694,11548,1146,23005,68584,0.4333,35.7,25014,63601,56655,1476,2435,74,958,2003,"Rice County, Minnesota",27,131,27131
3964.0,116.0,18.0,0.0,1,1962,1669,534,323,307,16,1135,863,805,58,1669,58576,0.4109,39.8,1938,3997,3819,25,10,2,7,134,"Red Lake County, Minnesota",27,125,27125
62486.0,2242.0,3576.0,232.0,262,33854,24364,5580,3094,3007,87,18784,14192,12405,1787,24364,65269,0.4202,37.5,26456,62943,57629,1441,1278,141,196,2258,"Clay County, Minnesota",27,027,27027
20726.0,516.0,260.0,73.0,203,10547,8616,2775,1738,1672,66,5841,4591,4207,384,8616,61207,0.406,39.6,9965,20577,18462,102,127,11,99,1776,"Fillmore County, Minnesota",27,045,27045
30996.0,830.0,1122.0,39.0,98,15490,12584,3781,1997,1883,114,8803,6349,5914,435,12584,59343,0.4239,39.0,14952,30934,28821,573,520,3,163,854,"Polk County, Minnesota",27,119,27119
14748.0,633.0,150.0,29.0,28,7846,6031,1855,1122,1064,58,4176,3262,3032,230,6031,63439,0.4089,40.3,6602,14772,13642,173,251,0,326,380,"Sibley County, Minnesota",27,143,27143
10855.0,308.0,39.0,28.0,60,5423,4310,1508,822,808,14,2802,2220,2058,162,4310,54065,0.4279,39.6,5056,10843,8741,327,511,14,484,766,"Watonwan County, Minnesota",27,165,27165
4932.0,224.0,97.0,3.0,19,2327,2298,884,439,423,16,1414,1122,983,139,2298,53900,0.4234,38.9,3152,4862,4609,10,11,2,26,204,"Big Stone County, Minnesota",27,011,27011
28940.0,1546.0,286.0,41.0,86,12444,13164,5060,3387,3219,168,8104,6112,5542,570,13164,52204,0.4365,38.9,25866,28995,26564,205,82,19,9,2116,"Cass County, Minnesota",27,021,27021
20808.0,1012.0,440.0,54.0,55,9299,8688,3457,2369,2302,67,5231,4042,3683,359,8688,56709,0.4229,39.0,14817,20867,19487,121,68,10,156,1025,"Hubbard County, Minnesota",27,057,27057
19628.0,518.0,577.0,78.0,40,9727,8759,3074,1684,1574,110,5685,4277,3939,338,8759,52798,0.4342,39.9,9981,19660,18318,182,40,61,35,1024,"Martin County, Minnesota",27,091,27091
21406.0,310.0,281.0,103.0,37,10521,8033,2325,1416,1377,39,5708,4439,4185,254,8033,55304,0.4162,39.8,8659,21429,16423,1407,1811,28,1034,726,"Nobles County, Minnesota",27,105,27105
93197.0,6878.0,863.0,336.0,902,50737,32206,6991,4659,4389,270,25215,21863,19798,2065,32206,89250,0.3661,39.2,33934,92421,87193,1799,961,50,98,2320,"Sherburne County, Minnesota",27,141,27141
100821.0,5371.0,1191.0,224.0,1192,56143,36754,8076,5207,5055,152,28678,24147,22511,1636,36754,101496,0.4238,38.9,38271,101658,94259,2915,1459,67,414,2544,"Carver County, Minnesota",27,019,27019
35441.0,1403.0,318.0,47.0,80,18784,14714,4593,2734,2566,168,10121,7733,6917,816,14714,62121,0.4132,38.9,15890,35599,33177,425,307,37,301,1352,"McLeod County, Minnesota",27,085,27085
536792.0,30494.0,13069.0,4515.0,18623,277577,209043,55383,30231,28339,1892,153660,109798,93923,15875,209043,64660,0.46,37.2,219977,540315,436185,43118,32601,3070,7845,17496,"Ramsey County, Minnesota",27,123,27123
50167.0,2299.0,1923.0,250.0,526,27885,19442,5571,3414,3297,117,13871,9944,8033,1911,19442,59329,0.4341,36.7,21220,50270,45865,481,992,44,138,2750,"Winona County, Minnesota",27,169,27169
20448.0,1056.0,198.0,39.0,174,11159,7756,1960,1259,1230,29,5796,4740,4448,292,7756,74575,0.3864,40.1,8241,20574,19191,181,305,45,71,781,"Dodge County, Minnesota",27,039,27039
63639.0,2449.0,1089.0,74.0,83,30461,26820,9442,6077,5749,328,17378,13223,11835,1388,26820,56549,0.4562,38.5,41916,63444,59816,549,132,13,119,2815,"Crow Wing County, Minnesota",27,035,27035
132858.0,5411.0,1337.0,226.0,602,71737,48242,11046,7204,6872,332,37196,31194,28809,2385,48242,84974,0.3881,38.9,51815,133647,125690,2104,1318,41,284,4210,"Wright County, Minnesota",27,171,27171
5605.0,233.0,162.0,7.0,11,2717,2468,905,497,477,20,1563,1117,1026,91,2468,53077,0.4492,40.9,3135,5512,5203,21,19,0,8,261,"Lincoln County, Minnesota",27,081,27081
25582.0,1671.0,170.0,54.0,152,11947,10249,3239,1882,1754,128,7010,5308,4861,447,10249,56135,0.4215,38.5,12914,25419,23631,168,130,16,27,1447,"Mille Lacs County, Minnesota",27,095,27095
35348.0,1604.0,314.0,56.0,46,16578,13613,4105,2582,2438,144,9508,7533,6800,733,13613,63098,0.4024,37.5,16062,34304,32527,214,143,4,12,1404,"Carlton County, Minnesota",27,017,27017
15957.0,744.0,100.0,18.0,45,7646,6439,2235,1504,1383,121,4204,3300,2975,325,6439,57163,0.3918,38.3,7931,15915,14898,105,17,4,32,859,"Kanabec County, Minnesota",27,065,27065
87170.0,4115.0,867.0,32.0,87,37911,32036,10052,7136,6948,188,21984,17157,16452,705,32036,58308,0.4065,40.3,36714,85980,77841,582,276,85,427,6769,"St. Clair County, Alabama",01,115,01115
82251.0,2602.0,889.0,31.0,22,33790,31034,10370,6205,6040,165,20664,16524,15534,990,31034,44918,0.4416,39.4,37842,81979,71400,598,889,215,424,8453,"Cullman County, Alabama",01,043,01043
103437.0,1861.0,2632.0,252.0,19,43855,39311,12339,7561,7349,212,26972,19779,18398,1381,39311,47580,0.4832,38.9,47457,103775,91273,1023,576,159,738,10006,"Houston County, Alabama",01,069,01069
204675.0,7743.0,8502.0,742.0,497,92277,72461,18419,11710,11359,351,54042,40126,35608,4518,72461,53326,0.4677,37.4,90557,205775,185237,2151,3473,300,1919,12695,"Tuscaloosa County, Alabama",01,125,01125
51248.0,2517.0,2256.0,327.0,4,22345,19924,5977,3666,3596,70,13947,10805,10151,654,19924,55637,0.4327,39.9,23188,50029,43668,829,650,60,451,4371,"Coffee County, Alabama",01,031,01031
43674.0,1304.0,201.0,64.0,0,17263,16927,5030,2873,2812,61,11897,9719,9096,623,16927,47468,0.4719,39.9,19781,43726,36944,449,652,189,717,4775,"Chilton County, Alabama",01,021,01021
10670.0,549.0,125.0,18.0,0,4075,4032,1577,957,935,22,2455,1781,1722,59,4032,38990,0.4515,40.1,6585,10348,9469,4,49,0,0,826,"Coosa County, Alabama",01,037,01037
101729.0,3156.0,1455.0,192.0,37,41552,38942,13420,7788,7514,274,25522,19526,18338,1188,38942,44637,0.4594,39.5,47704,101958,89271,945,961,175,827,9779,"Etowah County, Alabama",01,055,01055
13732.0,303.0,177.0,19.0,35,5191,5856,2290,1331,1271,60,3566,2695,2624,71,5856,38364,0.472,40.4,7403,13720,12216,25,25,0,68,1386,"Lamar County, Alabama",01,075,01075
19610.0,345.0,135.0,12.0,12,7820,6506,2232,1412,1376,36,4274,3096,2955,141,6506,40688,0.4619,39.5,10089,19538,17698,71,75,7,0,1687,"Butler County, Alabama",01,013,01013
63362.0,2775.0,691.0,48.0,28,23982,25019,8774,5467,5255,212,16245,12900,11911,989,25019,43629,0.4522,39.4,31141,63390,55478,351,112,45,444,6960,"Walker County, Alabama",01,127,01127
8237.0,27.0,12.0,31.0,0,2381,2951,1342,609,572,37,1609,1009,970,39,2951,24145,0.5115,38.3,5112,8269,7189,16,7,0,0,1057,"Greene County, Alabama",01,063,01063
10201.0,185.0,36.0,11.0,0,4319,3521,1120,713,674,39,2401,1899,1830,69,3521,37785,0.4731,41.1,4557,9865,8678,65,0,0,0,1122,"Bullock County, Alabama",01,011,01011
33346.0,772.0,603.0,83.0,36,14367,13448,4652,2909,2834,75,8796,6433,5719,714,13448,42289,0.423,39.8,16988,33252,29274,125,424,10,60,3359,"Chambers County, Alabama",01,017,01017
2511.0,104.0,21.0,0.0,2,1143,1007,493,267,206,61,514,452,414,38,1007,58059,0.3985,44.5,1691,2513,2059,83,35,0,11,325,"Haines Borough, Alaska",02,100,02100
31994.0,634.0,1463.0,307.0,747,17110,12676,2909,1804,1638,166,9767,7182,6135,1047,12676,88390,0.3985,40.6,13698,31496,26100,1372,715,265,458,2586,"Juneau City and Borough, Alaska",02,110,02110
5298.0,217.0,77.0,16.0,11,2120,1856,544,316,284,32,1312,891,800,91,1856,41413,0.4671,40.3,4090,5346,3845,33,21,3,14,1430,"Yukon-Koyukuk Census Area, Alaska",02,290,02290
2243.0,154.0,480.0,121.0,10,1550,613,163,84,84,0,450,291,237,54,613,81719,0.3486,42.5,1533,2188,1639,44,101,0,28,376,"Denali Borough, Alaska",02,068,02068
2122.0,109.0,94.0,0.0,25,971,791,305,219,208,11,486,308,270,38,791,59803,0.4306,45.4,1643,2136,1535,31,42,5,42,481,"Hoonah-Angoon Census Area, Alaska",02,105,02105
2466.0,66.0,66.0,8.0,3,1009,1027,404,255,251,4,623,447,403,44,1027,53894,0.4208,45.8,1512,2482,1950,12,53,0,5,462,"Wrangell City and Borough, Alaska",02,275,02275
1016043.0,18429.0,38805.0,9036.0,10109,442389,404739,137560,87362,81519,5843,267179,193810,167294,26516,404739,53379,0.4694,37.6,459912,1005471,811029,58712,43319,4973,24402,63036,"Pima County, Arizona",04,019,04019
53133.0,2673.0,1531.0,176.0,30,18221,21945,10689,6932,6321,611,11256,8321,7791,530,21945,43524,0.4427,38.5,33542,52797,46011,903,609,101,260,4913,"Gila County, Arizona",04,007,04007
124269.0,4473.0,6211.0,1156.0,311,46499,50163,19976,12273,11277,996,30187,22825,21185,1640,50163,49260,0.4427,38.8,61108,116349,97248,6485,3578,619,1433,6986,"Cochise County, Arizona",04,003,04003
70728.0,1482.0,634.0,73.0,190,18181,20867,7458,4867,4741,126,13409,9458,9075,383,20867,32508,0.5013,38.4,32891,70867,52425,471,189,13,250,17519,"Apache County, Arizona",04,001,04001
206318.0,2912.0,8251.0,3390.0,1542,78082,73098,26284,18118,17017,1101,46814,39621,37029,2592,73098,45243,0.4429,40.1,92625,202580,132933,21117,22788,3278,7320,15144,"Yuma County, Arizona",04,027,04027
107713.0,5354.0,1941.0,275.0,442,32824,34990,13125,8925,8432,493,21865,16971,15923,1048,34990,40067,0.4739,37.7,58011,106822,90663,1221,869,206,595,13268,"Navajo County, Arizona",04,017,04017
14724.0,286.0,288.0,7.0,0,6283,6444,2339,1210,1171,39,4105,3182,2969,213,6444,37233,0.4663,40.1,8038,14771,13694,79,40,0,4,954,"Clay County, Arkansas",05,021,05021
18153.0,693.0,396.0,25.0,0,7789,7157,2199,1369,1299,70,4958,3854,3352,502,7157,46997,0.4941,37.8,8655,18000,16863,66,78,5,77,911,"Drew County, Arkansas",05,043,05043
17459.0,807.0,330.0,9.0,2,6798,7355,2484,1522,1462,60,4871,3646,3532,114,7355,37218,0.4756,40.5,8609,17391,15939,105,84,42,82,1139,"Randolph County, Arkansas",05,121,05121
36793.0,1289.0,1049.0,25.0,13,15796,15034,5045,3168,3104,64,9989,7885,7351,534,15034,45374,0.4364,40.1,17020,36902,34038,216,86,0,2,2560,"Boone County, Arkansas",05,009,05009
13356.0,996.0,198.0,7.0,6,3098,3773,1339,891,866,25,2434,1984,1845,139,3773,46596,0.4604,39.6,4932,8363,7662,37,41,4,26,593,"Lincoln County, Arkansas",05,079,05079
47915.0,993.0,1077.0,107.0,51,20378,19074,4958,2924,2786,138,14116,10303,9178,1125,19074,40161,0.4689,40.5,21798,48179,43588,154,411,20,271,3735,"Crittenden County, Arkansas",05,035,05035
122396.0,5340.0,1858.0,294.0,88,57834,44575,10291,6419,6268,151,34284,26042,22574,3468,44575,52827,0.4674,38.9,49842,122146,109029,1141,1245,267,1317,9147,"Faulkner County, Arkansas",05,045,05045
68209.0,2787.0,1942.0,67.0,37,29636,25975,8922,5487,5266,221,17053,13981,13148,833,25975,46157,0.45,39.1,30353,67530,58415,387,431,33,133,8131,"Walker County, Georgia",13,295,13295
905129.0,27852.0,25861.0,6904.0,4897,447008,293330,60194,43891,42591,1300,233136,191184,179506,11678,293330,71026,0.4267,39.4,309166,910143,605890,92205,61630,15591,65844,68983,"Gwinnett County, Georgia",13,135,13135
78017.0,3911.0,1480.0,228.0,96,36695,26305,6882,4540,4352,188,19423,16288,15528,760,26305,62345,0.3931,39.6,28423,78857,63355,2496,1620,493,1498,9395,"Barrow County, Georgia",13,013,13013
12997.0,298.0,414.0,156.0,22,4073,3675,1178,841,805,36,2497,2015,1880,135,3675,41961,0.4222,39.0,4524,11859,9426,46,16,13,145,2213,"Charlton County, Georgia",13,049,13049
6600.0,191.0,0.0,20.0,0,2188,2477,769,497,443,54,1708,1292,1196,96,2477,27658,0.5192,40.2,3016,6597,5208,56,50,0,102,1181,"Clinch County, Georgia",13,065,13065
103721.0,5237.0,941.0,214.0,351,47075,37627,10331,7135,6760,375,27296,22130,20660,1470,37627,57423,0.4388,40.2,41072,103876,85243,1459,1722,414,1988,13050,"Bartow County, Georgia",13,015,13015
141406.0,8556.0,2752.0,458.0,550,68502,49187,11462,7994,7618,376,37725,29610,27199,2411,49187,63835,0.41,39.7,52686,142126,114496,5890,3355,699,2751,14935,"Douglas County, Georgia",13,097,13097
24529.0,905.0,396.0,10.0,0,10116,9136,3122,1775,1751,24,6014,4918,4569,349,9136,43531,0.4599,40.1,10869,24639,19758,96,166,13,1003,3603,"Grady County, Georgia",13,131,13131
8505.0,861.0,86.0,8.0,6,2122,2974,1292,728,669,59,1682,1127,1086,41,2974,31860,0.4697,40.8,5391,6054,5375,12,9,0,28,630,"Hancock County, Georgia",13,141,13141
102709.0,2141.0,1747.0,154.0,28,47081,35629,9809,6266,5963,303,25820,21026,19756,1270,35629,48623,0.4585,38.8,40039,103393,73727,4567,7906,836,6135,10222,"Whitfield County, Georgia",13,313,13313
13262.0,952.0,55.0,0.0,0,4309,4696,1500,851,841,10,3196,2256,2192,64,4696,32161,0.4998,39.3,6104,11267,9048,78,34,28,127,1952,"Macon County, Georgia",13,193,13193
68963.0,2475.0,1301.0,345.0,18,29039,24928,7188,4421,4348,73,17740,13291,12599,692,24928,45649,0.4715,40.0,28529,68479,58295,872,1203,130,773,7206,"Troup County, Georgia",13,285,13285
33864.0,1617.0,768.0,55.0,71,15380,12156,4193,3004,2980,24,7963,6813,6601,212,12156,76319,0.4436,39.9,14168,33448,30533,453,187,51,66,2158,"Harris County, Georgia",13,145,13145
5174.0,308.0,0.0,4.0,0,2142,1864,579,358,358,0,1285,1097,1094,3,1864,44448,0.444,38.8,2206,5221,4416,25,37,0,0,743,"Schley County, Georgia",13,249,13249
20282.0,389.0,221.0,0.0,1,8721,8002,2607,1794,1747,47,5395,4485,4149,336,8002,45398,0.4566,39.3,9336,20332,16341,207,37,0,82,3665,"Worth County, Georgia",13,321,13321
13606.0,1092.0,84.0,40.0,58,4923,5020,1808,1027,1013,14,3212,2525,2337,188,5020,37340,0.4815,39.8,6260,12384,10227,82,8,103,306,1658,"Dooly County, Georgia",13,093,13093
10610.0,750.0,110.0,0.0,14,4137,4020,1298,779,688,91,2722,2194,2059,135,4020,42607,0.4574,39.9,4749,10153,8282,102,51,24,316,1378,"Evans County, Georgia",13,109,13109
2594.0,92.0,59.0,0.0,0,1067,1140,392,224,210,14,748,552,514,38,1140,37297,0.4952,41.1,1480,2606,2297,80,16,6,4,203,"Webster County, Georgia",13,307,13307
59573.0,2569.0,1071.0,82.0,40,28705,21172,4847,3124,3056,68,16325,13142,12368,774,21172,66822,0.4409,40.7,22745,59827,52926,866,714,67,277,4977,"Effingham County, Georgia",13,103,13103
2987.0,82.0,26.0,0.0,0,1298,1108,330,192,189,3,778,578,537,41,1108,45000,0.4538,40.0,1526,2915,2700,0,4,0,0,211,"Glascock County, Georgia",13,125,13125
2237.0,37.0,178.0,0.0,0,797,842,419,276,267,9,423,321,310,11,842,26667,0.4874,41.5,1956,2289,1721,14,14,28,91,421,"Quitman County, Georgia",13,239,13239
284652.0,11285.0,14635.0,2440.0,3435,138757,108568,30389,18408,17517,891,78179,57431,49568,7863,108568,56842,0.4869,39.0,125272,280698,228017,6375,6407,1271,4075,34553,"Chatham County, Georgia",13,051,13051
9606.0,481.0,235.0,43.0,0,3878,3393,1192,711,694,17,2201,1543,1514,29,3393,42446,0.4208,41.5,4116,9081,7756,65,0,0,0,1260,"Johnson County, Georgia",13,167,13167
10242.0,962.0,241.0,63.0,1,3707,3714,1022,610,610,0,2692,2012,1926,86,3714,40986,0.4687,41.0,4419,9700,8159,91,35,0,1,1414,"Lanier County, Georgia",13,173,13173
28913.0,1802.0,307.0,18.0,23,12620,10744,3448,2394,2325,69,7296,6106,5828,278,10744,52500,0.4205,38.8,12004,29006,24258,247,119,33,469,3880,"Madison County, Georgia",13,195,13195
22082.0,1122.0,171.0,32.0,32,8080,7982,2718,1524,1463,61,5264,4292,3991,301,7982,38116,0.4683,39.8,9065,19990,16481,36,37,0,249,3187,"Mitchell County, Georgia",13,205,13205
39817.0,1378.0,316.0,82.0,52,18231,15144,4262,2746,2638,108,10882,8659,8065,594,15144,45639,0.4571,38.1,16745,40057,31253,404,880,42,807,6671,"Tift County, Georgia",13,277,13277
41307.0,1669.0,619.0,118.0,51,17873,15038,4848,2881,2776,105,10190,8250,7375,875,15038,44891,0.4768,39.9,17023,41735,33734,731,717,78,1337,5138,"Polk County, Georgia",13,233,13233
6292.0,277.0,40.0,0.0,7,2552,2809,1188,791,770,21,1621,1177,1079,98,2809,38549,0.4411,40.8,3425,6302,5303,56,0,0,8,935,"Talbot County, Georgia",13,263,13263
8643.0,435.0,45.0,10.0,18,3298,3399,1250,766,745,21,2149,1728,1603,125,3399,34768,0.4709,38.3,4165,8379,6847,15,117,0,43,1357,"Terrell County, Georgia",13,273,13273
43946.0,2165.0,1665.0,55.0,39,19068,17595,5473,3645,3498,147,12122,9221,8663,558,17595,43740,0.5001,40.0,20715,44003,36814,201,429,49,409,6101,"Thomas County, Georgia",13,275,13275
8906.0,309.0,29.0,0.0,9,3228,3185,1101,664,610,54,2084,1568,1469,99,3185,38996,0.4838,39.9,4488,8925,8025,12,17,5,132,734,"Wilkinson County, Georgia",13,319,13319
14713.0,572.0,120.0,21.0,0,6431,5651,2038,1182,1111,71,3613,2681,2600,81,5651,47120,0.4158,39.9,6660,14802,12927,15,56,6,65,1733,"Oglethorpe County, Georgia",13,221,13221
6936.0,217.0,55.0,4.0,18,2372,2553,1049,686,667,19,1504,1099,944,155,2553,31699,0.45,39.5,3688,6863,5939,8,0,0,13,903,"Randolph County, Georgia",13,243,13243
35190.0,1516.0,710.0,0.0,68,13084,13823,4267,2817,2694,123,9556,6569,6215,354,13823,36869,0.4652,40.1,16718,33195,27391,143,248,0,20,5393,"Ware County, Georgia",13,299,13299
29313.0,651.0,754.0,58.0,67,10630,10400,3078,2035,1960,75,7322,5672,5206,466,10400,45483,0.4345,37.8,12287,27735,23173,143,243,20,148,4008,"Wayne County, Georgia",13,305,13305
8784.0,632.0,43.0,1.0,10,2585,2575,932,618,606,12,1643,1272,1201,71,2575,36964,0.4679,40.3,3522,6746,5577,14,11,17,92,1035,"Wilcox County, Georgia",13,315,13315
44612.0,3410.0,475.0,48.0,121,17605,16191,4625,2792,2671,121,11566,8334,6897,1437,16191,43672,0.4639,37.2,20588,43432,37346,479,445,5,264,4893,"Baldwin County, Georgia",13,009,13009
75404.0,8691.0,1519.0,200.0,384,33599,27375,6422,3941,3840,101,20953,16146,12813,3333,27375,45550,0.4689,36.8,31135,75305,63675,807,783,74,772,9194,"Bulloch County, Georgia",13,031,13031
2918.0,20.0,53.0,0.0,0,902,1242,534,277,272,5,708,478,436,42,1242,22325,0.4824,38.5,2073,2898,2407,28,0,11,30,422,"Clay County, Georgia",13,061,13061
3951.0,138.0,71.0,0.0,5,1748,1561,443,290,275,15,1118,835,822,13,1561,39494,0.5002,39.9,1871,3981,3005,23,19,87,114,733,"Echols County, Georgia",13,101,13101
739989.0,34777.0,22564.0,7562.0,27720,373862,282436,64159,38796,36574,2222,218277,147431,126942,20489,282436,62399,0.4894,39.4,311880,743368,558778,43135,37552,7097,31868,64938,"DeKalb County, Georgia",13,089,13089
29003.0,1351.0,813.0,49.0,0,12675,11259,3381,2166,2094,72,7878,6309,5866,443,11259,48550,0.4394,40.4,12466,28880,25136,86,100,27,23,3508,"Haralson County, Georgia",13,143,13143
15288.0,787.0,112.0,10.0,3,5963,5664,1913,1117,1077,40,3751,2806,2521,285,5664,33944,0.473,39.9,7283,15164,12750,115,57,31,138,2073,"Jefferson County, Georgia",13,163,13163
7791.0,295.0,94.0,0.0,9,3208,3475,1389,749,724,25,2086,1568,1418,150,3475,39742,0.4995,39.0,4890,7769,6749,25,29,6,0,960,"Lincoln County, Georgia",13,181,13181
39161.0,914.0,224.0,18.0,26,17291,14385,4248,2720,2585,135,10137,8636,7972,664,14385,48033,0.4096,39.4,16114,39495,31660,626,1458,98,659,4994,"Murray County, Georgia",13,213,13213
11142.0,525.0,219.0,16.0,1,3643,3687,1477,979,949,30,2210,1664,1530,134,3687,45148,0.446,39.2,4504,9676,8205,86,2,7,19,1357,"Pulaski County, Georgia",13,235,13235
16503.0,351.0,283.0,49.0,33,6049,6662,3045,2078,1885,193,3617,2533,2335,198,6662,42500,0.5086,37.9,12630,16407,13133,148,274,97,358,2397,"Rabun County, Georgia",13,241,13241
11477.0,525.0,336.0,55.0,9,4385,4898,2592,1739,1661,78,2306,1824,1579,245,4898,48219,0.4437,35.9,8229,11440,9866,159,58,70,14,1273,"Towns County, Georgia",13,281,13281
6699.0,624.0,42.0,13.0,0,2401,2490,921,520,520,0,1569,1158,1134,24,2490,32241,0.5255,39.2,3205,6454,5136,4,8,19,202,1085,"Treutlen County, Georgia",13,283,13283
9216.0,395.0,90.0,22.0,0,3586,3329,1224,650,641,9,2105,1483,1449,34,3329,37736,0.4814,37.8,4066,9190,7404,62,29,0,7,1688,"Irwin County, Georgia",13,155,13155
18137.0,428.0,63.0,8.0,22,7093,6656,2122,1412,1355,57,4534,3634,3520,114,6656,40304,0.4586,39.5,8567,17976,14775,229,212,89,384,2287,"Appling County, Georgia",13,001,13001
48062.0,1173.0,291.0,46.0,21,24734,18608,5330,3243,3154,89,13278,10584,9836,748,18608,63806,0.3917,39.4,20448,48410,45619,414,343,21,70,1943,"Shelby County, Ohio",39,149,39149
36409.0,1270.0,708.0,0.0,158,17576,15090,4755,2555,2486,69,10335,7870,7100,770,15090,53183,0.3983,39.3,16644,35749,33672,204,158,25,55,1635,"Williams County, Ohio",39,171,39171
102312.0,2086.0,1609.0,151.0,145,44198,41537,14314,8709,8240,469,27223,20578,19090,1488,41537,48345,0.4403,38.6,46829,99556,92484,531,122,137,327,5955,"Columbiana County, Ohio",39,029,39029
41742.0,1381.0,298.0,65.0,72,20975,16506,4921,3233,3119,114,11585,9320,8622,698,16506,63092,0.3908,39.4,17560,41843,39239,351,212,4,172,1865,"Fulton County, Ohio",39,051,39051
29769.0,891.0,560.0,12.0,20,12061,11588,3789,2195,2113,82,7799,5994,5450,544,11588,44858,0.4487,38.1,13896,29701,26489,145,187,16,3,2861,"Gallia County, Ohio",39,053,39053
227995.0,6068.0,3820.0,603.0,1184,102282,98472,33621,18812,18010,802,64851,45649,41543,4106,98472,46042,0.474,37.8,111361,225662,210488,3201,1349,153,384,10087,"Mahoning County, Ohio",39,099,39099
74998.0,2607.0,1228.0,85.0,59,27477,29858,9544,5682,5389,293,20314,15393,14083,1310,29858,41330,0.4891,37.8,34563,73255,68686,309,219,0,28,4013,"Scioto County, Ohio",39,145,39145
34782.0,1396.0,405.0,30.0,138,17237,12922,3989,2687,2564,123,8933,7429,6921,508,12922,59452,0.4039,40.1,14299,34810,32174,136,51,13,4,2432,"Morrow County, Ohio",39,117,39117
16328.0,896.0,573.0,105.0,18,5617,6782,3051,2006,1862,144,3731,2758,2576,182,6782,36719,0.4416,39.8,9490,16356,15110,152,158,0,18,918,"Marion County, Arkansas",05,089,05089
7803.0,166.0,149.0,45.0,19,3017,3327,1374,960,899,61,1953,1488,1434,54,3327,36438,0.4554,37.7,4936,7823,7268,20,29,9,21,476,"Searcy County, Arkansas",05,129,05129
262174.0,5325.0,9475.0,1350.0,162,128735,97249,24022,15940,15290,650,73227,59808,55096,4712,97249,66362,0.4586,41.1,105634,264163,217902,8614,14063,885,7179,15520,"Benton County, Arkansas",05,007,05007
33150.0,2028.0,511.0,21.0,26,12983,12599,4223,2701,2607,94,8376,6635,6250,385,12599,43889,0.428,39.2,14512,31424,28972,120,90,0,143,2099,"Hot Spring County, Arkansas",05,059,05059
15940.0,596.0,197.0,9.0,0,6487,6279,2087,1347,1263,84,4192,3193,3055,138,6279,41682,0.4771,40.1,7581,16133,13985,275,204,43,38,1588,"Madison County, Arkansas",05,087,05087
1839.0,36.0,104.0,4.0,6,783,759,357,207,207,0,402,309,284,25,759,45972,0.4306,43.6,1581,1857,1737,8,14,0,0,98,"Dolores County, Colorado",08,033,08033
1248.0,88.0,2.0,0.0,0,641,558,243,161,146,15,315,268,236,32,558,53300,0.3906,42.1,1319,1256,1112,45,22,0,5,72,"Jackson County, Colorado",08,057,08057
25865.0,515.0,842.0,43.0,5,10966,10655,3761,2427,2224,203,6894,5339,4834,505,10655,49470,0.4162,39.3,12331,25856,22231,254,234,26,231,2880,"Montezuma County, Colorado",08,083,08083
319596.0,15510.0,19732.0,3146.0,8423,172617,127415,31410,18783,17265,1518,96005,72004,56548,15456,127415,83019,0.4848,36.8,136096,320329,275894,13961,15593,574,4144,10163,"Boulder County, Colorado",08,013,08013
9889.0,380.0,196.0,362.0,3,4815,4028,1292,784,752,32,2736,2248,2079,169,4028,52022,0.4235,40.7,4556,9866,8233,48,695,28,432,430,"Yuma County, Colorado",08,125,08125
24903.0,1188.0,928.0,69.0,358,14210,9603,2438,1604,1535,69,7165,5465,4452,1013,9603,77443,0.4632,37.6,16828,24935,22115,556,452,45,211,1556,"Routt County, Colorado",08,107,08107
9450.0,858.0,388.0,24.0,28,5040,4395,1368,766,736,30,3027,2089,1819,270,4395,67060,0.4205,38.4,5793,9382,8261,70,121,13,0,917,"Clear Creek County, Colorado",08,019,08019
164205.0,5015.0,4119.0,331.0,489,67418,64314,21126,12960,12216,744,43188,32075,28755,3320,64314,46783,0.4547,37.9,71223,162675,148304,1934,1604,298,980,9555,"Pueblo County, Colorado",08,101,08101
17804.0,1179.0,540.0,12.0,73,8787,6931,2235,1741,1665,76,4696,3520,3106,414,6931,73622,0.3978,40.0,14554,17738,15779,244,142,0,32,1541,"Park County, Colorado",08,093,08093
149727.0,5504.0,5277.0,274.0,226,69249,61742,20050,12179,11547,632,41692,31755,27618,4137,61742,55379,0.4419,38.7,66599,150129,131519,2596,1467,171,1991,12385,"Mesa County, Colorado",08,077,08077
690030.0,16273.0,49457.0,6574.0,2476,345748,257507,61830,39300,37502,1798,195677,153622,138050,15572,257507,68779,0.4322,39.3,272379,667275,582042,23608,13715,1423,8187,38300,"El Paso County, Colorado",08,041,08041
636903.0,39208.0,21814.0,5057.0,14201,343091,240304,57824,36314,34848,1466,182480,138967,122764,16203,240304,77469,0.4522,39.4,251212,637690,513146,39975,35528,3061,18430,27550,"Arapahoe County, Colorado",08,005,08005
551119.0,4106.0,21338.0,3018.0,10209,271770,205829,58242,36819,34812,2007,147587,109655,97402,12253,205829,73892,0.4584,38.5,223259,547702,465034,29317,26516,1437,6495,18903,"New Castle County, Delaware",10,003,10003
174500.0,4222.0,6846.0,579.0,862,80857,65796,20455,13746,12975,771,45341,35564,32163,3401,65796,60910,0.4279,38.4,71753,173035,152263,5241,3234,273,1903,10121,"Kent County, Delaware",10,001,10001
180620.0,4615.0,3209.0,254.0,1345,95123,74143,25871,16095,14991,1104,48272,37015,33480,3535,74143,79906,0.4566,38.6,88252,180743,160798,7850,5102,414,1029,5550,"Litchfield County, Connecticut",09,005,09005
1450578.0,34177.0,37930.0,17146.0,10967,672240,554095,230883,137734,127643,10091,323212,244519,217655,26864,554095,63299,0.5219,38.7,686410,1451973,988718,175767,98208,23734,72289,93257,"Palm Beach County, Florida",12,099,12099
2669811.0,26899.0,24932.0,49286.0,60693,1289937,883372,286486,199108,188645,10463,596886,457352,417803,39549,883372,51347,0.5231,38.6,1024194,2675253,1093415,733996,398605,99187,209670,140380,"Miami-Dade County, Florida",12,086,12086
11748.0,1070.0,276.0,11.0,21,4207,4444,1871,1170,1120,50,2573,1809,1609,200,4444,46643,0.5056,38.4,8725,10226,8197,98,58,31,42,1800,"Franklin County, Florida",12,037,12037
14217.0,1692.0,74.0,1.0,9,3684,4381,1624,1166,1067,99,2757,2148,2015,133,4381,38569,0.4683,38.7,5827,11031,9317,60,142,0,132,1380,"Hamilton County, Florida",12,047,12047
124527.0,3890.0,5598.0,791.0,39,24569,56230,43398,30463,29024,1439,12832,8921,8185,736,56230,57226,0.4354,36.5,70800,115706,104208,3684,1305,175,355,5979,"Sumter County, Florida",12,119,12119
19179.0,1703.0,447.0,0.0,18,6793,7092,2825,1750,1679,71,4267,3314,3100,214,7092,39102,0.4525,38.9,8711,17634,14417,59,36,28,181,2913,"Holmes County, Florida",12,059,12059
731126.0,14067.0,28376.0,6080.0,2030,303259,275965,128973,86576,80600,5976,146992,111987,101158,10829,275965,57832,0.4798,38.6,394047,732479,547294,51981,35624,8514,26970,62096,"Lee County, Florida",12,071,12071
368010.0,8152.0,15617.0,4991.0,2415,154198,142979,72784,50117,47237,2880,70195,54949,50318,4631,142979,69653,0.5257,38.9,214473,369593,250362,35836,26651,7181,24446,25117,"Collier County, Florida",12,021,12021
519760.0,21915.0,15064.0,2574.0,929,215400,204198,79646,50384,46829,3555,124552,97376,88438,8938,204198,52828,0.4517,39.2,243451,518687,417321,27768,14064,3399,7025,49110,"Pasco County, Florida",12,101,12101
102683.0,3158.0,3070.0,1236.0,349,32924,41740,23257,15528,14313,1215,18483,13735,12752,983,41740,40942,0.4855,38.4,55791,102275,82592,4633,3709,478,2469,8394,"Highlands County, Florida",12,055,12055
36683.0,1918.0,563.0,520.0,595,13381,12072,4876,3302,3062,240,7196,5597,5201,396,12072,35438,0.4404,40.8,15189,35122,25064,1361,1958,250,1825,4664,"DeSoto County, Florida",12,027,12027
69077.0,5833.0,1657.0,178.0,23,25974,25133,8557,5611,5262,349,16576,11588,10483,1105,25133,46494,0.4589,39.8,29033,65174,55042,1110,858,62,436,7666,"Columbia County, Florida",12,023,12023
72523.0,2802.0,1123.0,82.0,71,25535,28943,11997,7122,6577,545,16946,12690,11479,1211,28943,37670,0.4584,38.2,37415,72177,59186,814,630,179,1209,10159,"Putnam County, Florida",12,107,12107
15175.0,3126.0,178.0,2.0,39,3641,3960,1185,810,778,32,2775,2209,2032,177,3960,44270,0.4873,39.6,4608,9538,8388,77,42,0,101,930,"Union County, Florida",12,125,12125
39997.0,2216.0,760.0,56.0,14,14821,16374,6831,4285,4004,281,9543,7057,6295,762,16374,37326,0.4524,39.1,20601,40142,32951,650,457,125,512,5447,"Levy County, Florida",12,075,12075
531419.0,17678.0,13961.0,3477.0,2325,223733,216495,88157,54460,50383,4077,128338,94064,81966,12098,216495,49494,0.4594,38.3,260720,531217,437753,22158,10237,2738,4848,53483,"Volusia County, Florida",12,127,12127
18379.0,1403.0,79.0,104.0,40,6151,6778,2573,1433,1382,51,4205,3158,2850,308,6778,37037,0.4797,39.1,8639,16371,13810,254,231,0,105,1971,"Madison County, Florida",12,079,12079
309972.0,8766.0,17860.0,1519.0,917,143048,120104,37357,23661,22385,1276,82747,57815,49180,8635,120104,50915,0.4448,38.8,141355,297945,255383,7327,4412,666,2841,27316,"Escambia County, Florida",12,033,12033
200931.0,6557.0,13989.0,1642.0,443,97376,77962,22328,13495,12750,745,55634,41891,37571,4320,77962,63412,0.4328,39.5,97058,190732,158164,6694,3521,771,2451,19131,"Okaloosa County, Florida",12,091,12091
32046.0,2176.0,1297.0,100.0,49,15445,11570,3869,2457,2368,89,7701,6292,5432,860,11570,51790,0.4738,37.1,13607,32075,27480,390,486,100,289,3330,"Lumpkin County, Georgia",13,187,13187
5730.0,282.0,57.0,6.0,44,2403,2333,864,496,490,6,1469,1161,1066,95,2333,44542,0.4732,39.4,2765,5625,4748,9,15,0,4,849,"Miller County, Georgia",13,201,13201
37669.0,2297.0,713.0,67.0,8,18497,13423,3996,2662,2619,43,9427,8298,8108,190,13423,90751,0.4623,38.9,14217,37924,33178,1327,890,7,275,2247,"Oconee County, Georgia",13,219,13219
223291.0,12253.0,5653.0,515.0,1029,106468,75984,17865,13316,12947,369,58119,48066,45864,2202,75984,71288,0.3919,39.6,81428,224123,186843,10122,3991,1245,2468,19454,"Henry County, Georgia",13,151,13151
18438.0,2160.0,896.0,0.0,10,7174,5695,944,690,661,29,4751,3709,3485,224,5695,54605,0.3787,42.8,6850,17822,14630,132,310,29,496,2225,"Long County, Georgia",13,183,13183
25343.0,1225.0,476.0,158.0,0,10371,9543,3508,2274,2253,21,6035,4752,4530,222,9543,47164,0.4525,38.6,12624,25750,21874,331,67,0,173,3305,"Stephens County, Georgia",13,257,13257
14735.0,545.0,109.0,0.0,0,5253,5279,1628,1058,1018,40,3651,2945,2772,173,5279,36669,0.4357,38.3,6521,14941,11951,124,120,92,187,2467,"Jeff Davis County, Georgia",13,161,13161
6358.0,984.0,24.0,20.0,2,1666,1736,636,387,349,38,1100,909,803,106,1736,34167,0.4748,40.8,2399,4447,3679,3,7,7,107,644,"Calhoun County, Georgia",13,037,13037
151033.0,8798.0,2159.0,582.0,639,62193,58116,16379,9698,9181,517,41737,28103,25718,2385,58116,41334,0.52,38.3,70130,149723,126618,2368,1368,350,980,18039,"Bibb County, Georgia",13,021,13021
8340.0,126.0,272.0,16.0,40,3194,3408,1220,747,747,0,2188,1693,1649,44,3408,44643,0.4344,41.0,4200,8332,7261,163,20,9,81,798,"Marion County, Georgia",13,197,13197
12699.0,910.0,98.0,7.0,0,4482,4176,1572,918,891,27,2604,1967,1836,131,4176,48174,0.4415,38.8,5323,12434,11043,134,74,7,30,1146,"Bleckley County, Georgia",13,023,13023
22513.0,1079.0,267.0,39.0,31,9110,8460,2966,1828,1758,70,5494,4515,4365,150,8460,42488,0.4911,38.3,10660,22557,18714,185,334,55,210,3059,"Franklin County, Georgia",13,119,13119
18480.0,1246.0,208.0,31.0,2,6837,6494,2209,1374,1372,2,4285,2667,2374,293,6494,44846,0.4783,38.3,7591,18417,15865,156,73,92,48,2183,"Lamar County, Georgia",13,171,13171
22117.0,1649.0,538.0,59.0,57,8196,8387,2506,1632,1591,41,5881,4432,4092,340,8387,37453,0.461,40.1,9935,21749,17693,89,125,9,322,3511,"Emanuel County, Georgia",13,107,13107
13850.0,529.0,174.0,30.0,6,5589,5171,1797,1246,1225,21,3374,2766,2582,184,5171,51250,0.4159,39.9,6445,13825,11937,109,99,0,127,1553,"Jasper County, Georgia",13,159,13159
60050.0,3810.0,6584.0,1041.0,176,27281,23485,3857,2640,2539,101,19628,15216,14118,1098,23485,48007,0.3971,42.5,28212,55089,46112,1671,1153,53,341,5759,"Liberty County, Georgia",13,179,13179
8240.0,268.0,92.0,11.0,32,2903,3363,1299,849,818,31,2064,1439,1344,95,3363,33357,0.6006,39.7,4832,8212,6844,16,35,9,0,1308,"Seminole County, Georgia",13,253,13253
8174.0,80.0,61.0,4.0,12,2844,3044,1332,738,738,0,1712,1144,1100,44,3044,34879,0.4787,40.2,4253,8166,7269,7,110,0,8,772,"Twiggs County, Georgia",13,289,13289
8093.0,235.0,118.0,16.0,7,3024,3473,1196,717,682,35,2277,1620,1526,94,3473,33832,0.4839,39.3,4605,8046,6595,39,0,27,67,1318,"Taylor County, Georgia",13,269,13269
26614.0,1503.0,789.0,0.0,44,10109,10030,3109,1732,1670,62,6921,5261,4867,394,10030,40175,0.5396,40.3,12218,26722,21066,340,438,229,518,4131,"Toombs County, Georgia",13,279,13279
40558.0,981.0,319.0,41.0,3,19450,16251,5275,3391,3267,124,10976,8776,8099,677,16251,58957,0.4027,39.4,17902,40773,37847,188,141,16,59,2522,"Preble County, Ohio",39,135,39135
101992.0,3231.0,2198.0,346.0,325,47375,40650,12299,7412,7087,325,28351,21018,19194,1824,40650,53131,0.4328,38.0,45081,100774,93534,645,468,68,389,5670,"Allen County, Ohio",39,003,39003
41420.0,1577.0,243.0,72.0,54,18508,17782,5974,3467,3352,115,11808,8790,7877,913,17782,44971,0.4519,38.6,20044,41253,38402,255,224,0,67,2305,"Crawford County, Ohio",39,033,39033
38650.0,1159.0,440.0,0.0,47,16442,16220,5460,3220,3004,216,10760,8281,7355,926,16220,45917,0.4392,39.2,19335,38683,35598,219,98,19,0,2749,"Guernsey County, Ohio",39,059,39059
40191.0,1094.0,453.0,114.0,80,20755,16234,4752,2914,2748,166,11482,9208,8713,495,16234,62952,0.3934,39.3,18032,40467,38685,168,205,7,199,1203,"Mercer County, Ohio",39,107,39107
133113.0,5127.0,2299.0,408.0,446,60047,54696,18351,10692,10292,400,36345,28180,25167,3013,54696,50873,0.4306,38.1,61272,133040,122816,1158,708,179,692,7487,"Clark County, Ohio",39,023,39023
304566.0,10041.0,4128.0,996.0,1017,140858,120281,38386,23330,22146,1184,81895,62531,57338,5193,120281,58427,0.4506,38.0,131211,301415,277820,5082,3025,241,610,14637,"Lorain County, Ohio",39,093,39093
524552.0,16845.0,11760.0,2443.0,6060,241969,224328,67230,38698,36601,2097,157098,110232,97663,12569,224328,51542,0.4659,37.9,254810,523385,467462,12281,8970,879,3917,29876,"Montgomery County, Ohio",39,113,39113
226896.0,12211.0,4808.0,1641.0,468,112349,82957,21430,14231,13853,378,61527,51568,48301,3267,82957,87125,0.4317,38.9,87165,221527,199211,7681,6366,52,811,7406,"Warren County, Ohio",39,165,39165
96763.0,2757.0,1191.0,82.0,171,39407,37832,12683,7536,7216,320,25149,18761,16802,1959,37832,46700,0.4508,38.1,46174,94978,84618,739,415,66,95,9045,"Ashtabula County, Ohio",39,007,39007
44054.0,1897.0,1595.0,128.0,32,18511,17610,5864,3446,3290,156,11746,8676,7732,944,17610,46809,0.457,39.7,21515,43691,36985,397,423,53,246,5587,"Kay County, Oklahoma",40,071,40071
14273.0,829.0,232.0,6.0,0,5569,5422,1925,1200,1177,23,3497,2710,2506,204,5422,43329,0.4241,39.5,6753,13593,11466,50,56,0,68,1953,"Craig County, Oklahoma",40,035,40035
138818.0,7210.0,3330.0,244.0,141,69794,44906,11855,7643,7491,152,33051,27282,25725,1557,44906,72056,0.3989,39.9,48467,138461,119736,3162,1422,478,1199,12464,"Canadian County, Oklahoma",40,017,40017
10215.0,457.0,269.0,17.0,3,3727,4088,1554,974,930,44,2534,2046,1932,114,4088,44214,0.4874,40.6,5050,10137,8000,78,18,22,37,1982,"Latimer County, Oklahoma",40,077,40077
20526.0,336.0,423.0,259.0,36,10677,6768,1661,940,853,87,5107,3948,3669,279,6768,52282,0.3852,41.3,8232,20685,13421,861,2492,149,2101,1661,"Texas County, Oklahoma",40,139,40139
11030.0,446.0,194.0,9.0,0,3871,4477,1752,1052,1016,36,2725,2049,1950,99,4477,37692,0.4864,40.5,6179,11018,8964,19,8,38,22,1967,"Pushmataha County, Oklahoma",40,127,40127
10963.0,391.0,226.0,2.0,20,4088,4267,1536,943,902,41,2731,2054,1968,86,4267,41332,0.4354,40.7,5197,10942,9015,57,38,0,39,1793,"Johnston County, Oklahoma",40,069,40069
5322.0,94.0,136.0,24.0,4,2423,1971,629,422,412,10,1342,1108,1037,71,1971,52349,0.4062,42.6,2682,5298,4301,81,200,10,223,483,"Beaver County, Oklahoma",40,007,40007
13216.0,546.0,64.0,16.0,12,4092,4132,1641,978,956,22,2491,1896,1822,74,4132,39365,0.4744,40.0,6267,11921,9488,51,46,18,31,2287,"Hughes County, Oklahoma",40,063,40063
119893.0,3881.0,12133.0,1458.0,684,55316,42842,10530,6180,5809,371,32312,24145,22076,2069,42842,52161,0.4456,41.5,51637,108744,89362,2954,2229,287,704,13208,"Comanche County, Oklahoma",40,031,40031
21897.0,545.0,420.0,33.0,7,7908,7733,2488,1608,1542,66,5245,4320,4043,277,7733,34695,0.4472,39.6,9380,22078,15899,96,123,57,113,5790,"Adair County, Oklahoma",40,001,40001
43167.0,1032.0,849.0,27.0,13,17935,16720,5615,3332,3230,102,11105,8659,8039,620,16720,47214,0.45,40.2,20710,43057,36417,437,395,105,225,5478,"Stephens County, Oklahoma",40,137,40137
47899.0,1114.0,1039.0,268.0,34,20626,18339,5465,3347,3255,92,12874,9515,8831,684,18339,51419,0.4447,40.4,21723,47692,39357,438,628,65,436,6768,"Carter County, Oklahoma",40,019,40019
5774.0,946.0,162.0,9.0,0,1948,2054,775,352,331,21,1279,987,955,32,2054,41488,0.4345,41.5,2715,4822,3988,3,13,20,24,774,"Greer County, Oklahoma",40,055,40055
19526.0,406.0,115.0,8.0,35,6699,8327,3555,2230,2156,74,4772,3609,3384,225,8327,39084,0.4593,40.1,13777,19438,15515,90,20,0,57,3756,"McIntosh County, Oklahoma",40,091,40091
13761.0,445.0,237.0,8.0,0,5727,5238,1641,1097,1037,60,3597,2636,2417,219,5238,52478,0.433,41.0,6847,13563,11501,132,51,0,194,1685,"Murray County, Oklahoma",40,099,40099
31074.0,947.0,779.0,44.0,39,12595,11847,3909,2355,2261,94,7938,6159,5696,463,11847,39872,0.4474,39.0,14063,30996,25240,199,242,74,227,5014,"Ottawa County, Oklahoma",40,115,40115
78132.0,5665.0,1177.0,78.0,93,36244,29208,8619,6031,5874,157,20589,16939,15814,1125,29208,62795,0.4048,39.9,32290,78663,67637,1241,843,157,794,7991,"Wagoner County, Oklahoma",40,145,40145
28941.0,1086.0,589.0,130.0,43,11203,10320,3468,1997,1881,116,6852,5501,5154,347,10320,46592,0.4474,42.3,13225,27929,22815,160,124,37,253,4540,"Caddo County, Oklahoma",40,015,40015
67906.0,3807.0,1740.0,103.0,155,26193,26234,8047,4588,4402,186,18187,14117,13438,679,26234,43078,0.4877,39.2,30981,65760,53843,524,563,138,563,10129,"Muskogee County, Oklahoma",40,101,40101
45943.0,1143.0,2152.0,51.0,49,19464,17253,5737,3491,3351,140,11516,9040,8032,1008,17253,44212,0.4618,39.7,20333,45993,37151,288,311,62,466,7715,"Bryan County, Oklahoma",40,013,40013
214499.0,4860.0,6883.0,473.0,958,93137,88241,32891,20098,18531,1567,55350,43518,37585,5933,88241,53412,0.4662,37.2,95431,215294,188779,5625,5072,452,2195,13171,"Jackson County, Oregon",41,029,41029
7141.0,122.0,207.0,1.0,0,2923,3381,1443,817,785,32,1938,1440,1173,267,3381,44712,0.441,40.5,4407,7090,6502,141,59,2,0,386,"Grant County, Oregon",41,023,41023
406173.0,18663.0,9715.0,1512.0,5972,201061,157408,50785,32758,30852,1906,106623,87041,77718,9323,157408,80484,0.4457,38.6,167104,408754,358524,18726,9883,984,3840,16797,"Clackamas County, Oregon",41,005,41005
26215.0,921.0,622.0,46.0,80,10142,10784,4515,2830,2644,186,6269,4686,4035,651,10784,49895,0.4248,37.6,19000,25781,23141,404,438,0,551,1247,"Tillamook County, Oregon",41,057,41057
85281.0,2548.0,2788.0,95.0,100,31519,36367,15692,10361,9518,843,20675,16060,14148,1912,36367,45616,0.4513,36.9,39103,85640,75869,1459,1458,156,490,6208,"Josephine County, Oregon",41,033,41033
76107.0,2526.0,2104.0,351.0,170,31653,26908,8018,5042,4769,273,18890,15428,13799,1629,26908,54699,0.4319,39.2,30499,72736,61566,2128,3717,101,1659,3565,"Umatilla County, Oregon",41,059,41059
50744.0,2483.0,1932.0,62.0,108,21974,19671,6588,4238,3974,264,13083,10299,9197,1102,19671,62257,0.4357,38.7,21315,51097,47198,713,354,47,242,2543,"Columbia County, Oregon",41,009,41009
25914.0,1201.0,686.0,64.0,29,11471,10305,3560,2241,2064,177,6745,5154,4538,616,10305,53105,0.4141,38.3,11678,25712,22100,415,1192,54,419,1532,"Wasco County, Oregon",41,065,41065
8973.0,836.0,80.0,14.0,13,3437,3097,985,619,556,63,2112,1652,1546,106,3097,41996,0.4991,39.3,3973,8583,7048,186,98,29,121,1101,"Montgomery County, Georgia",13,209,13209
88831.0,5725.0,2677.0,121.0,388,39880,31076,8750,6169,5910,259,22326,17846,16876,970,31076,60189,0.4229,39.3,33681,88912,70097,4769,1864,809,1463,9910,"Rockdale County, Georgia",13,247,13247
7893.0,263.0,27.0,0.0,0,2472,1862,753,423,412,11,1109,765,747,18,1862,30192,0.4452,39.7,2634,7706,6045,6,2,0,0,1653,"Wheeler County, Georgia",13,309,13309
18520.0,589.0,207.0,55.0,10,7583,6740,2230,1469,1461,8,4510,3472,3414,58,6740,47811,0.4162,39.6,7739,18689,15217,204,413,18,223,2614,"Banks County, Georgia",13,011,13011
124666.0,15845.0,5151.0,910.0,2694,59563,48844,9909,5871,5494,377,38935,26729,18652,8077,48844,38623,0.522,34.8,52941,125443,100502,3128,4932,735,3848,12298,"Clarke County, Georgia",13,059,13059
83450.0,4031.0,1915.0,159.0,192,38274,34119,11756,7223,6912,311,22363,16724,15343,1381,34119,52977,0.5123,38.9,43110,83446,69101,1750,837,241,1433,10084,"Glynn County, Georgia",13,127,13127
67201.0,3019.0,917.0,162.0,132,30652,23166,6934,5003,4819,184,16232,13932,13028,904,23166,65385,0.4291,40.0,25388,67179,56657,1540,1050,164,795,6973,"Jackson County, Georgia",13,157,13157
28368.0,1142.0,212.0,0.0,6,12048,10701,3631,2259,2217,42,7070,5851,5453,398,10701,56020,0.4271,39.9,11843,28298,25218,154,130,16,16,2764,"Jones County, Georgia",13,169,13169
192875.0,6929.0,12084.0,1706.0,1070,82945,72759,18616,10586,10159,427,54143,37606,34642,2964,72759,46408,0.498,39.3,84723,185535,156285,4924,2939,700,1345,19342,"Muscogee County, Georgia",13,215,13215
6291.0,621.0,603.0,638.0,0,1494,1816,695,408,398,10,1121,752,740,12,1816,29732,0.488,39.7,2346,4081,3399,17,0,0,0,665,"Stewart County, Georgia",13,259,13259
7900.0,518.0,74.0,0.0,8,3072,3169,1133,721,702,19,2036,1687,1595,92,3169,37039,0.4761,40.1,3938,7650,6557,45,62,61,67,858,"Turner County, Georgia",13,287,13287
8111.0,121.0,9.0,0.0,0,3232,2880,803,479,477,2,2077,1590,1499,91,2880,37197,0.4735,39.4,3512,8217,6030,74,260,117,583,1153,"Atkinson County, Georgia",13,003,13003
3109.0,134.0,8.0,0.0,0,1062,1425,537,303,294,9,888,520,494,26,1425,32917,0.4874,40.5,1924,3132,2691,33,46,25,54,283,"Baker County, Georgia",13,007,13007
10726.0,406.0,270.0,9.0,0,4317,4013,1253,697,675,22,2760,2182,2100,82,4013,33736,0.5252,39.1,4770,10553,8155,31,51,6,468,1842,"Candler County, Georgia",13,043,13043
115707.0,7763.0,2455.0,324.0,230,52131,41903,11328,7708,7320,388,30575,24845,22438,2407,41903,53737,0.428,39.2,45374,115960,98932,1143,1588,251,1714,12332,"Carroll County, Georgia",13,045,13045
22518.0,1025.0,287.0,12.0,29,8873,8585,2890,1549,1549,0,5695,4360,4163,197,8585,36042,0.5545,38.5,10792,22303,18572,79,148,36,240,3228,"Crisp County, Georgia",13,081,13081
741983.0,32655.0,21433.0,6401.0,3826,389924,280374,62219,42092,40331,1761,218155,167211,149208,18003,280374,77932,0.4501,39.8,300047,746238,573791,47667,32962,6208,30606,55004,"Cobb County, Georgia",13,067,13067
16023.0,583.0,935.0,73.0,18,6924,6195,2163,1388,1336,52,4032,3399,3203,196,6195,42581,0.4437,36.9,7290,15973,13782,102,126,0,30,1933,"Dade County, Georgia",13,083,13083
15503.0,540.0,418.0,12.0,45,6018,6335,2211,1252,1232,20,4124,2976,2783,193,6335,38285,0.5482,39.9,7791,15494,12453,71,167,6,97,2700,"Brooks County, Georgia",13,027,13027
18975.0,814.0,453.0,13.0,10,7685,7559,2831,1594,1535,59,4728,3777,3530,247,7559,38678,0.4702,38.5,9630,18934,16084,143,205,51,97,2354,"Elbert County, Georgia",13,105,13105
8671.0,252.0,19.0,29.0,0,3188,3443,1130,603,580,23,2313,1703,1515,188,3443,27375,0.4417,38.1,4821,8717,7059,178,9,0,273,1198,"Jenkins County, Georgia",13,165,13165
106466.0,5544.0,3242.0,221.0,333,47787,37018,9736,7126,6834,292,27282,21508,19787,1721,37018,56316,0.4388,39.2,39312,107131,88636,3042,1564,706,1151,12032,"Newton County, Georgia",13,217,13217
44805.0,1556.0,1361.0,180.0,265,18245,15505,4680,3107,2910,197,10825,8408,7753,655,15505,36435,0.4841,39.5,18650,45058,33987,601,969,380,2552,6569,"Colquitt County, Georgia",13,071,13071
279153.0,19954.0,7586.0,940.0,4202,125885,94279,18681,12991,12285,706,75598,54682,50535,4147,94279,47864,0.4147,38.6,105593,279870,204346,13792,10218,3877,10025,37612,"Clayton County, Georgia",13,063,13063
196406.0,8241.0,3896.0,708.0,246,92200,64352,19111,13301,12970,331,45241,37878,35179,2699,64352,62984,0.4596,39.7,73135,197765,146312,7667,9502,1397,13822,19065,"Hall County, Georgia",13,139,13139
164374.0,2187.0,4394.0,1801.0,1984,83031,54479,20323,15027,14195,832,34156,27035,24054,2981,54479,80948,0.4403,38.4,73169,164492,128171,16358,11799,492,2140,5532,"Maui County, Hawaii",15,009,15009
4307.0,13.0,264.0,0.0,0,1706,1615,577,368,355,13,1038,822,802,20,1615,53841,0.3583,37.7,1999,4356,3951,36,35,0,59,275,"Oneida County, Idaho",16,071,16071
17168.0,563.0,332.0,8.0,4,7061,6683,2677,1693,1632,61,4006,3154,2953,201,6683,45492,0.4175,38.7,7349,17205,13943,133,144,22,251,2712,"Gem County, Idaho",16,045,16045
4067.0,387.0,241.0,12.0,12,1551,1757,886,588,568,20,871,656,636,20,1757,48856,0.4392,39.2,2690,4072,3547,22,14,4,8,477,"Adams County, Idaho",16,003,16003
23211.0,1403.0,488.0,335.0,86,10761,8022,2107,1308,1180,128,5915,5119,4525,594,8022,52921,0.4114,41.4,8531,23616,17535,461,1219,173,2045,2183,"Jerome County, Idaho",16,053,16053
3811.0,197.0,107.0,2.0,6,1408,1646,713,370,341,29,933,668,578,90,1646,41198,0.4534,39.5,1948,3809,3169,45,19,3,12,561,"Lewis County, Idaho",16,061,16061
11419.0,820.0,532.0,56.0,24,5058,4321,1496,988,903,85,2825,2346,2210,136,4321,43798,0.4434,41.8,4914,11448,8489,173,309,102,524,1851,"Owyhee County, Idaho",16,073,16073
11694.0,466.0,519.0,40.0,22,4511,4653,1688,1099,1043,56,2965,2082,1834,248,4653,43423,0.4787,37.8,5474,11762,9432,147,194,62,101,1826,"Boundary County, Idaho",16,021,16021
6831.0,101.0,140.0,35.0,0,2921,2538,795,469,454,15,1743,1447,1379,68,2538,59053,0.4049,38.5,3291,6878,6210,68,69,16,58,457,"Caribou County, Idaho",16,029,16029
84556.0,3841.0,3093.0,447.0,401,36893,31155,8417,5156,4902,254,22738,17411,15159,2252,31155,51734,0.4402,36.8,34279,84697,74288,1144,1773,154,386,6952,"Bannock County, Idaho",16,005,16005
112481.0,4054.0,4429.0,624.0,1524,50312,39768,10598,6731,6491,240,29170,23481,22062,1419,39768,60615,0.4504,37.7,42925,113366,99552,2305,2090,525,1138,7756,"Bonneville County, Idaho",16,019,16019
214871.0,7975.0,8194.0,891.0,261,94309,72807,20147,13343,12795,548,52660,41984,38283,3701,72807,52134,0.408,38.7,76247,216118,175252,5471,5959,1155,4662,23619,"Canyon County, Idaho",16,027,16027
39226.0,2545.0,2200.0,325.0,230,19659,15422,3586,2220,2117,103,11836,8599,6356,2243,15422,49158,0.4568,35.4,16960,39345,34581,748,1440,69,152,2355,"Latah County, Idaho",16,057,16057
194801.0,5316.0,2791.0,616.0,1336,92845,83711,23885,13611,12894,717,59826,42056,37329,4727,83711,61912,0.4589,37.9,91737,194848,181414,3042,2760,62,439,7131,"Sangamon County, Illinois",17,167,17167
32001.0,1698.0,270.0,62.0,7,12984,11883,3972,2326,2263,63,7911,5939,5522,417,11883,53816,0.4295,39.0,13944,28544,26838,86,125,34,86,1375,"Randolph County, Illinois",17,157,17157
50362.0,1718.0,707.0,84.0,124,24628,21021,6477,3755,3604,151,14544,11346,10508,838,21021,60986,0.4052,40.3,22663,50520,46371,825,963,22,380,1959,"Ogle County, Illinois",17,141,17141
33943.0,2009.0,552.0,29.0,111,15344,13719,4503,2445,2322,123,9216,6660,6079,581,13719,51437,0.4234,37.5,15463,32076,30384,240,303,0,53,1096,"Morgan County, Illinois",17,137,17137
13791.0,291.0,112.0,7.0,21,5851,6041,2041,1120,1073,47,4000,3048,2930,118,6041,49290,0.4205,39.6,7164,13527,12725,99,51,0,76,576,"White County, Illinois",17,193,17193
6763.0,174.0,159.0,7.0,18,3255,2977,1171,759,711,48,1806,1434,1295,139,2977,53676,0.393,38.9,3868,6754,6302,42,18,0,24,368,"Henderson County, Illinois",17,071,17071
170454.0,9476.0,2669.0,639.0,933,87703,65845,15435,9175,8874,301,50410,37642,31329,6313,65845,67675,0.4725,36.4,72384,171425,154218,4180,6216,194,778,5839,"McLean County, Illinois",17,113,17113
21027.0,1223.0,162.0,18.0,66,8047,8433,2772,1584,1520,64,5661,4404,4141,263,8433,52428,0.459,39.0,9610,18617,17768,87,30,36,3,693,"Perry County, Illinois",17,145,17145
142014.0,3236.0,3677.0,413.0,1047,66665,60546,19333,10753,10393,360,41213,29873,27132,2741,60546,54858,0.4286,37.8,66160,141174,124163,4115,5520,417,1374,5585,"Rock Island County, Illinois",17,161,17161
11440.0,154.0,184.0,5.0,8,5329,4839,1674,985,929,56,3165,2397,2296,101,4839,50770,0.434,39.0,5570,11466,10495,57,99,2,64,749,"Wabash County, Illinois",17,185,17185
10704.0,599.0,23.0,17.0,7,5265,4299,1440,841,817,24,2859,2321,2130,191,4299,56206,0.4103,38.5,4872,10711,10065,48,30,0,30,538,"Cumberland County, Illinois",17,035,17035
21471.0,579.0,527.0,14.0,75,10644,9970,3996,2427,2288,139,5974,4422,3977,445,9970,57946,0.4334,39.3,13699,21432,19980,189,166,4,115,978,"Jo Daviess County, Illinois",17,085,17085
15864.0,1003.0,504.0,17.0,21,6110,6306,2049,1160,1109,51,4257,3237,2997,240,6306,46636,0.4263,40.6,7129,13675,12491,118,33,9,42,982,"Lawrence County, Illinois",17,101,17101
11477.0,429.0,67.0,40.0,0,5213,4884,1755,979,963,16,3129,2359,2157,202,4884,58465,0.4162,38.4,5919,11415,10834,112,62,6,16,385,"Marshall County, Illinois",17,123,17123
32730.0,1117.0,467.0,92.0,76,14508,13901,4692,2578,2325,253,9209,6958,6255,703,13901,52834,0.423,39.1,15614,31256,29637,104,158,0,0,1357,"Christian County, Illinois",17,021,17021
57294.0,5573.0,1877.0,662.0,371,24138,23883,5945,3459,3302,157,17938,11493,8976,2517,23883,37241,0.5249,34.3,28962,57450,50781,974,2033,4,341,3317,"Jackson County, Illinois",17,077,17077
180634.0,5047.0,2175.0,624.0,1514,80295,73253,21177,11919,11495,424,52076,35956,32202,3754,73253,55842,0.4842,37.7,83703,180546,161968,4171,4645,193,792,8777,"Peoria County, Illinois",17,143,17143
16213.0,729.0,124.0,4.0,23,8211,6692,2168,1331,1289,42,4524,3557,3433,124,6692,70849,0.3865,38.9,7406,16347,15525,85,96,3,19,619,"Piatt County, Illinois",17,147,17147
5387.0,104.0,30.0,0.0,7,2454,2315,792,444,434,10,1523,1155,1091,64,2315,54907,0.4554,39.6,2653,5345,5001,31,22,0,10,281,"Stark County, Illinois",17,175,17175
16475.0,962.0,314.0,35.0,30,7334,6299,2090,1181,1120,61,4209,3383,2990,393,6299,57289,0.4307,37.6,7238,15347,14186,120,161,28,30,822,"Bond County, Illinois",17,005,17005
14326.0,489.0,318.0,25.0,14,6453,6508,2521,1434,1367,67,3987,2964,2656,308,6508,52410,0.4198,39.6,8475,14182,13081,187,52,0,41,821,"Carroll County, Illinois",17,015,17015
21824.0,901.0,333.0,74.0,9,10265,8499,2903,1694,1657,37,5596,4460,4096,364,8499,63028,0.3975,38.5,10148,21588,20490,64,130,16,3,885,"Jersey County, Illinois",17,083,17083
315446.0,13706.0,8058.0,2535.0,6050,169339,114170,29472,20038,19337,701,84698,69633,64494,5139,114170,121160,0.4092,39.0,119494,315151,242280,39115,21522,2053,4506,5675,"Howard County, Maryland",24,027,24027
897488.0,19077.0,31704.0,8071.0,72077,476296,311343,83263,54719,51951,2768,228080,166196,151510,14686,311343,84920,0.3994,38.5,333041,901883,663269,81523,66327,6611,51357,32796,"Prince George's County, Maryland",24,033,24033
564476.0,20079.0,18407.0,3417.0,10606,301362,209814,58270,38629,36496,2133,151544,119881,110000,9881,209814,100798,0.4133,39.6,224378,547742,485105,24788,13811,1485,7353,15200,"Anne Arundel County, Maryland",24,003,24003
819111.0,26514.0,12840.0,5546.0,19150,415113,313519,98152,58394,55480,2914,215367,164141,148115,16026,313519,76866,0.452,38.7,337052,819867,690282,52418,34290,3577,14049,25251,"Baltimore County, Maryland",24,005,24005
248431.0,7788.0,6215.0,1088.0,3193,132469,92526,24949,16245,15634,611,67577,55734,50587,5147,92526,97730,0.4045,38.8,97486,249075,215326,14220,8366,874,4224,6065,"Frederick County, Maryland",24,021,24021
90816.0,3309.0,2060.0,481.0,1520,46864,31973,9264,6552,6402,150,22709,19174,17709,1465,31973,109313,0.3768,39.2,35155,90150,84295,1558,814,82,85,3316,"Calvert County, Maryland",24,009,24009
28997.0,533.0,601.0,42.0,55,13608,12425,4485,2690,2595,95,7940,6149,5640,509,12425,52617,0.4475,39.1,19338,28751,26462,193,96,8,17,1975,"Garrett County, Maryland",24,023,24023
19362.0,668.0,800.0,102.0,141,9116,8025,3489,2054,1951,103,4536,3299,2896,403,8025,58598,0.4773,37.6,10686,19161,17502,220,434,28,205,772,"Kent County, Maryland",24,029,24029
1031521.0,17841.0,33417.0,16627.0,81686,553610,370950,107130,70315,67352,2963,263820,208169,191894,16275,370950,108820,0.4648,39.2,389202,1034552,676173,172281,112182,9985,41511,22420,"Montgomery County, Maryland",24,031,24031
17792.0,391.0,194.0,9.0,34,6000,4489,1005,850,809,41,3484,2853,2606,247,4489,53553,0.4502,36.9,6027,17878,13955,156,130,37,89,3511,"Bethel Census Area, Alaska",02,050,02050
9599.0,461.0,328.0,15.0,114,5338,1979,428,300,297,3,1551,1351,1226,125,1979,79306,0.4094,60.7,2618,9732,7353,304,268,15,29,1763,"North Slope Borough, Alaska",02,185,02185
8564.0,467.0,448.0,71.0,54,4660,3547,989,608,597,11,2558,1809,1526,283,3547,73682,0.4185,43.3,4225,8396,6447,333,246,25,95,1250,"Sitka City and Borough, Alaska",02,220,02220
97505.0,1856.0,6718.0,790.0,457,51000,36188,7044,4667,4274,393,29144,22400,19548,2852,36188,76992,0.4094,41.6,44189,91918,78603,2619,1707,154,392,8443,"Fairbanks North Star Borough, Alaska",02,090,02090
13622.0,244.0,667.0,95.0,273,7104,5397,1475,935,879,56,3922,2971,2574,397,5397,72728,0.4332,41.6,6401,13495,10832,723,403,45,58,1434,"Ketchikan Gateway Borough, Alaska",02,130,02130
104020.0,3913.0,2987.0,399.0,325,43212,31217,7497,5200,4838,362,23720,18889,17255,1634,31217,75493,0.422,41.1,41815,103269,85222,1791,935,298,451,14572,"Matanuska-Susitna Borough, Alaska",02,170,02170
9789.0,268.0,269.0,13.0,11,3638,2844,613,479,461,18,2231,1802,1667,135,2844,61048,0.4301,39.1,4108,9761,7582,63,97,24,67,1928,"Nome Census Area, Alaska",02,180,02180
4886.0,197.0,88.0,6.0,10,1912,1427,317,221,214,7,1110,890,827,63,1427,56898,0.4271,39.8,2456,4942,3800,85,23,7,0,1027,"Dillingham Census Area, Alaska",02,070,02070
645.0,21.0,63.0,0.0,1,320,219,70,41,36,5,149,98,91,7,219,71607,0.3385,46.0,418,649,477,7,11,4,10,140,"Yakutat City and Borough, Alaska",02,282,02282
1376.0,37.0,21.0,4.0,0,627,421,88,61,57,4,333,241,223,18,421,44135,0.4259,42.4,1479,1393,904,3,21,5,2,458,"Lake and Peninsula Borough, Alaska",02,164,02164
6768.0,402.0,301.0,44.0,10,2759,2170,683,468,465,3,1487,1115,1006,109,2170,70056,0.4058,43.6,3904,6780,5027,449,143,40,126,995,"Southeast Fairbanks Census Area, Alaska",02,240,02240
289343.0,5215.0,12312.0,2715.0,2321,153083,106567,22057,14493,13218,1275,84510,64014,55425,8589,106567,84928,0.4298,40.5,117380,282365,224591,16270,9847,2634,2722,26301,"Anchorage Municipality, Alaska",02,020,02020
3370.0,88.0,218.0,77.0,6,2262,890,206,137,135,2,684,508,415,93,890,69250,0.4068,59.5,1138,3380,1385,143,287,115,372,1078,"Aleutians East Borough, Alaska",02,013,02013
9174.0,258.0,569.0,10.0,31,4915,3177,738,455,426,29,2439,1701,1555,146,3177,79867,0.413,43.5,6181,9034,6793,167,337,9,27,1701,"Valdez-Cordova Census Area, Alaska",02,261,02261
57931.0,1599.0,2143.0,167.0,73,24671,21630,6683,4096,3864,232,14947,10936,9739,1197,21630,66064,0.4393,41.9,31249,57367,46708,1025,474,64,345,8751,"Kenai Peninsula Borough, Alaska",02,122,02122
1089.0,55.0,89.0,9.0,5,723,375,95,67,53,14,280,191,147,44,375,73906,0.3023,48.0,601,1107,833,52,20,11,15,176,"Skagway Municipality, Alaska",02,230,02230
6327.0,170.0,237.0,8.0,41,2606,2371,754,450,422,28,1617,1203,1103,100,2371,52379,0.4326,43.3,3430,6407,4649,101,76,5,19,1557,"Prince of Wales-Hyder Census Area, Alaska",02,198,02198
3203.0,91.0,145.0,12.0,12,1586,1187,464,307,294,13,723,543,472,71,1187,69948,0.4274,47.2,1782,3247,2671,152,113,2,19,290,"Petersburg Borough, Alaska",02,195,02195
8047.0,121.0,49.0,0.0,2,2140,1724,369,323,322,1,1355,1182,1118,64,1724,36754,0.4285,39.4,2231,8236,6587,1,6,2,34,1606,"Kusilvak Census Area, Alaska",02,158,02158
4278434.0,35232.0,150855.0,26707.0,40675,2040912,1552096,438707,286708,269301,17407,1113389,851595,749422,102173,1552096,64468,0.4641,38.9,1740694,4297311,3359943,238326,242458,26826,132452,297306,"Maricopa County, Arizona",04,013,04013
37539.0,2843.0,1133.0,235.0,22,12848,11017,3561,2392,2299,93,7456,5917,5487,430,11017,51353,0.4196,37.6,13586,34503,31647,298,187,23,41,2307,"Graham County, Arizona",04,009,04009
45761.0,1067.0,533.0,923.0,134,17041,15853,5690,3957,3808,149,10163,8509,8208,301,15853,41259,0.4997,38.5,18334,46061,28638,7791,4916,1022,1653,2041,"Santa Cruz County, Arizona",04,023,04023
20565.0,276.0,970.0,333.0,20,6063,9346,5194,3524,3230,294,4152,2904,2700,204,9346,34643,0.4879,39.8,16300,20651,16371,554,686,75,690,2275,"La Paz County, Arizona",04,012,04012
205918.0,3125.0,13982.0,919.0,704,71243,86889,42086,27896,25886,2010,44803,33760,29576,4184,86889,45587,0.4456,38.2,114573,204435,176125,6028,4064,450,1566,16202,"Mohave County, Arizona",04,015,04015
139871.0,10308.0,7995.0,709.0,1059,65367,47447,12061,8245,7856,389,35386,26754,20993,5761,47447,59460,0.4667,36.5,66086,140443,119836,2449,2421,223,1145,14369,"Coconino County, Arizona",04,005,04005
226522.0,7660.0,10367.0,615.0,303,86002,98386,48010,30510,28524,1986,50376,37595,32888,4707,98386,52451,0.4435,37.2,116842,226584,193878,7062,3471,722,2740,18711,"Yavapai County, Arizona",04,025,04025
9300.0,858.0,327.0,10.0,0,3837,3132,827,587,560,27,2305,1867,1779,88,3132,63473,0.3805,41.1,4453,9477,8860,86,91,6,40,394,"Greenlee County, Arizona",04,011,04011
427935.0,25062.0,18541.0,2352.0,381,154661,141300,55571,38785,36591,2194,85729,67610,62486,5124,141300,58174,0.4204,39.1,174329,406677,342012,15706,13007,1337,4322,30293,"Pinal County, Arizona",04,021,04021
8293.0,507.0,575.0,0.0,12,3130,3397,1166,761,757,4,2231,1666,1506,160,3397,38042,0.4086,39.6,4606,8193,7423,2,1,0,0,767,"Nevada County, Arkansas",05,099,05099
16538.0,810.0,194.0,9.0,5,7531,6653,2172,1461,1347,114,4481,3592,3305,287,6653,46787,0.4593,41.3,7956,16598,15307,10,5,0,27,1249,"Cross County, Arkansas",05,037,05037
7180.0,583.0,277.0,0.0,2,2921,2969,1209,640,627,13,1760,1212,1170,42,2969,38072,0.4249,38.7,4346,6519,6093,4,1,0,0,421,"Dallas County, Arkansas",05,039,05039
23475.0,1183.0,767.0,35.0,12,8826,8562,2895,1404,1339,65,5667,4439,4220,219,8562,36193,0.4973,36.8,11666,23354,21359,137,199,0,64,1595,"Columbia County, Arkansas",05,027,05027
118072.0,5357.0,2255.0,234.0,48,57074,44075,13905,9052,8799,253,30170,23912,22497,1415,44075,64412,0.399,39.8,48619,118198,108262,1695,1185,266,714,6076,"Saline County, Arkansas",05,125,05125
16511.0,737.0,351.0,66.0,0,5604,6813,3033,1811,1695,116,3780,3017,2936,81,6813,38499,0.4504,39.1,10488,16457,14794,45,37,9,120,1452,"Van Buren County, Arkansas",05,141,05141
13407.0,742.0,267.0,0.0,0,4664,4851,2030,1372,1313,59,2821,1942,1811,131,4851,42876,0.4278,40.2,7279,12634,11737,23,91,2,11,770,"Izard County, Arkansas",05,065,05065
37023.0,1609.0,616.0,38.0,43,15695,14322,4473,2765,2688,77,9849,7765,7241,524,14322,44319,0.4561,38.4,16525,36939,33015,310,387,12,345,2870,"Independence County, Arkansas",05,063,05063
21412.0,1095.0,403.0,2.0,39,8891,8417,2997,1878,1773,105,5420,4298,4066,232,8417,41466,0.4243,39.7,10163,21420,19712,186,101,0,41,1380,"Logan County, Arkansas",05,083,05083
17916.0,910.0,319.0,3.0,0,7645,6863,2268,1562,1515,47,4595,3639,3492,147,6863,55388,0.4471,40.4,8008,17949,16840,72,182,0,32,823,"Grant County, Arkansas",05,053,05053
17385.0,1174.0,329.0,20.0,54,6584,6723,2348,1387,1354,33,4375,3446,3183,263,6723,38923,0.4533,38.9,8024,17449,16293,162,42,2,19,931,"Franklin County, Arkansas",05,047,05047
10664.0,482.0,136.0,17.0,3,4569,4280,1545,922,879,43,2735,2139,2090,49,4280,40401,0.4481,40.1,5631,10598,9404,90,136,47,118,803,"Pike County, Arkansas",05,109,05109
68628.0,3711.0,873.0,297.0,65,25658,26801,8469,4910,4731,179,18332,12716,11563,1153,26801,40726,0.4642,39.0,33389,64532,59190,381,582,0,168,4211,"Jefferson County, Arkansas",05,069,05069
8869.0,390.0,211.0,9.0,6,3181,3754,1631,949,939,10,2123,1688,1624,64,3754,35741,0.454,37.9,5845,8815,7824,36,56,14,134,751,"Montgomery County, Arkansas",05,097,05097
10171.0,264.0,209.0,11.0,3,3644,3944,1455,918,902,16,2489,1752,1667,85,3944,36092,0.4331,39.1,5281,10312,9109,154,14,0,0,1035,"Scott County, Arkansas",05,127,05127
125773.0,4072.0,3821.0,416.0,170,56302,51228,14358,8232,7785,447,36870,27747,25124,2623,51228,46228,0.4691,39.3,56841,126506,105652,4468,3275,423,3215,9473,"Sebastian County, Arkansas",05,131,05131
61960.0,2149.0,1590.0,221.0,38,26040,23958,7200,4662,4366,296,16758,13252,12716,536,23958,46828,0.4477,39.9,26836,62057,54906,766,1361,52,333,4639,"Crawford County, Arkansas",05,033,05033
10447.0,563.0,180.0,0.0,7,3282,4068,1497,826,782,44,2571,1913,1854,59,4068,34147,0.5252,39.5,5415,9939,8944,31,43,54,110,757,"Chicot County, Arkansas",05,017,05017
26062.0,753.0,365.0,98.0,36,10297,9682,3054,1793,1754,39,6628,5209,4896,313,9682,38511,0.4491,38.7,11486,26188,21813,566,913,213,771,1912,"Johnson County, Arkansas",05,071,05071
9047.0,835.0,107.0,4.0,2,2744,3206,1141,716,687,29,2065,1396,1307,89,3206,29681,0.5049,40.8,4364,7588,6955,6,82,0,4,541,"Lee County, Arkansas",05,077,05077
32904.0,1708.0,1154.0,81.0,83,16705,13365,4138,2463,2387,76,9227,7136,6495,641,13365,61038,0.3993,37.9,14236,32938,31321,311,208,67,25,1006,"Marion County, Iowa",19,125,19125
21751.0,833.0,521.0,56.0,34,11011,8832,2720,1652,1572,80,6112,5045,4596,449,8832,62556,0.3951,40.2,9742,21769,19408,378,279,31,198,1475,"Washington County, Iowa",19,183,19183
12568.0,661.0,266.0,102.0,5,5673,5718,1897,1084,1005,79,3821,2796,2548,248,5718,53333,0.416,40.7,6514,12564,11490,158,328,56,144,388,"Wright County, Iowa",19,197,19197
12896.0,451.0,211.0,27.0,70,6307,5921,2065,1013,959,54,3856,2700,2410,290,5921,50187,0.4317,39.9,6577,12836,12125,13,135,0,18,545,"Cass County, Iowa",19,029,19029
11180.0,342.0,243.0,3.0,6,5694,5319,1745,1012,957,55,3574,2494,2211,283,5319,56550,0.4275,40.1,5770,10999,10379,83,86,0,0,451,"Cherokee County, Iowa",19,035,19035
16901.0,494.0,149.0,47.0,2,7727,6437,2001,1186,1156,30,4436,3701,3328,373,6437,55755,0.4913,42.2,7065,16857,13233,602,1558,10,743,711,"Crawford County, Iowa",19,047,19047
39001.0,1043.0,1288.0,45.0,71,18680,16891,5698,3142,3018,124,11193,8259,7348,911,16891,51267,0.4619,38.7,18603,38894,36439,197,347,79,60,1772,"Des Moines County, Iowa",19,057,19057
19519.0,740.0,262.0,53.0,25,9631,8200,2827,1581,1545,36,5373,4192,3786,406,8200,51128,0.4506,39.0,9597,19470,18361,60,83,0,24,942,"Fayette County, Iowa",19,065,19065
13935.0,282.0,417.0,6.0,12,7206,6019,1858,1102,1074,28,4161,3353,3016,337,6019,63854,0.4217,40.8,6821,13845,13210,53,42,0,0,540,"Harrison County, Iowa",19,085,19085
14750.0,427.0,340.0,21.0,41,7194,6646,2287,1300,1256,44,4359,3269,2997,272,6646,56073,0.4163,40.9,7508,14750,13858,68,94,1,26,703,"Kossuth County, Iowa",19,109,19109
14886.0,719.0,477.0,0.0,60,7297,5554,1726,1163,1110,53,3828,2989,2803,186,5554,72079,0.4219,38.8,6133,14836,14065,95,64,0,35,577,"Mills County, Iowa",19,129,19129
8620.0,460.0,145.0,10.0,12,4285,4000,1439,710,669,41,2561,1955,1758,197,4000,47605,0.4506,40.1,4722,8519,8089,11,4,0,0,415,"Monona County, Iowa",19,133,19133
42316.0,728.0,340.0,137.0,128,21051,16660,4777,2725,2602,123,11883,9478,8582,896,16660,58453,0.4179,39.5,18159,42309,38252,1193,1259,135,156,1314,"Muscatine County, Iowa",19,139,19139
5976.0,163.0,179.0,1.0,9,3067,2633,879,491,464,27,1754,1352,1169,183,2633,59725,0.4047,41.5,2956,5970,5597,34,72,0,149,118,"Osceola County, Iowa",19,143,19143
473307.0,16131.0,11874.0,1641.0,3695,252623,187798,43930,25901,24451,1450,143868,107097,92996,14101,187798,67637,0.4403,39.1,200593,474865,416117,17038,18286,1181,6671,15572,"Polk County, Iowa",19,153,19153
36125.0,1911.0,839.0,60.0,92,16515,15306,4777,2333,2263,70,10529,7471,6572,899,15306,47466,0.4456,39.3,17022,34763,32073,360,402,21,195,1712,"Webster County, Iowa",19,187,19187
96097.0,7254.0,5212.0,1106.0,3147,50350,37811,7776,4784,4574,210,30035,22150,14704,7446,37811,56756,0.466,34.2,39962,96284,84300,2079,5600,100,1337,2868,"Story County, Iowa",19,169,19169
101119.0,1700.0,2797.0,133.0,466,51151,39016,10827,6202,5946,256,28189,22113,19826,2287,39016,59224,0.4293,39.3,42260,101611,89378,3908,2501,608,1328,3888,"Woodbury County, Iowa",19,193,19193
130760.0,5774.0,2637.0,635.0,332,67604,52905,14691,8458,8111,347,38214,28083,23319,4764,52905,53539,0.4694,37.0,57894,131172,117597,3253,3806,249,1117,5150,"Black Hawk County, Iowa",19,013,19013
12174.0,597.0,122.0,39.0,18,6129,5155,1662,993,973,20,3493,2801,2586,215,5155,68038,0.4184,41.1,5584,12139,11836,42,20,58,0,183,"Grundy County, Iowa",19,075,19075
20395.0,800.0,252.0,15.0,23,9614,8130,2724,1591,1523,68,5406,4071,3820,251,8130,57549,0.4121,40.9,8985,19435,18610,117,104,5,13,586,"Jones County, Iowa",19,105,19105
10494.0,265.0,71.0,10.0,3,5323,4355,1563,802,787,15,2792,2154,2058,96,4355,58302,0.3954,39.8,4974,10403,9684,42,52,0,15,610,"Mitchell County, Iowa",19,131,19131
9947.0,343.0,347.0,22.0,18,4845,4554,1510,766,705,61,3044,2424,2194,230,4554,51696,0.4449,39.9,5233,9864,9333,46,136,7,0,342,"Montgomery County, Iowa",19,137,19137
9666.0,362.0,123.0,31.0,8,4928,4313,1505,879,849,30,2808,2166,2031,135,4313,58232,0.4248,40.7,5395,9630,9086,90,42,5,49,358,"Sac County, Iowa",19,161,19161
24805.0,649.0,598.0,12.0,23,13229,10250,3062,1859,1826,33,7188,5851,5474,377,10250,67297,0.4062,41.1,10834,24789,23106,281,173,0,324,905,"Plymouth County, Iowa",19,149,19149
20849.0,1114.0,210.0,62.0,38,10402,8029,2588,1448,1398,50,5441,4493,4171,322,8029,64837,0.4662,41.0,9094,20875,19669,96,55,0,14,1041,"Buchanan County, Iowa",19,019,19019
46312.0,891.0,1157.0,106.0,127,21648,19635,6450,3587,3426,161,13185,9982,8865,1117,19635,51688,0.4263,39.4,22026,46471,44231,300,204,46,111,1579,"Clinton County, Iowa",19,045,19045
7901.0,389.0,315.0,43.0,4,3597,3200,1065,674,664,10,2135,1564,1355,209,3200,44462,0.4422,37.0,3853,7864,6965,49,116,6,19,709,"Decatur County, Iowa",19,053,19053
17937.0,644.0,457.0,468.0,5,8931,6754,2602,1373,1263,110,4152,2975,2810,165,6754,47708,0.4886,39.6,7640,17990,15583,332,1255,4,88,728,"Jefferson County, Iowa",19,101,19101
13643.0,286.0,220.0,24.0,9,6655,5953,2060,1266,1193,73,3893,2873,2606,267,5953,52216,0.4155,41.0,7782,13531,12057,249,193,63,214,755,"Allamakee County, Iowa",19,005,19005
221531.0,6289.0,5410.0,547.0,700,117308,90877,24061,14131,13335,796,66816,49271,42804,6467,90877,64903,0.4277,38.9,97272,222016,205232,3913,4602,218,1158,6893,"Linn County, Iowa",19,113,19113
85762.0,7269.0,2090.0,244.0,163,46883,34399,7220,4140,3982,158,27179,21564,19543,2021,34399,88479,0.4255,40.4,36418,86620,77264,3604,3074,33,411,2234,"Dallas County, Iowa",19,049,19049
13578.0,596.0,242.0,45.0,196,7109,6169,1925,1020,1011,9,4244,2983,2639,344,6169,53703,0.417,39.3,6690,13620,12711,263,116,6,49,475,"O'Brien County, Iowa",19,141,19141
2026.0,18.0,13.0,13.0,0,914,733,222,105,105,0,511,417,381,36,733,52054,0.4214,46.3,1013,2022,1602,66,52,36,81,185,"Stanton County, Kansas",20,187,20187
4141.0,252.0,50.0,19.0,0,2097,1689,518,259,248,11,1171,961,927,34,1689,59316,0.3997,42.3,1991,4057,3245,174,135,6,130,367,"Meade County, Kansas",20,119,20119
32109.0,1091.0,929.0,42.0,0,14342,13576,4566,2418,2352,66,9010,6573,5943,630,13576,45157,0.4434,38.0,16467,32010,27746,350,105,81,303,3425,"Montgomery County, Kansas",20,125,20125
9366.0,519.0,194.0,18.0,7,4498,3652,1167,736,704,32,2485,1905,1699,206,3652,52327,0.4275,38.4,4480,9220,8348,50,104,32,25,661,"Pratt County, Kansas",20,151,20151
2462.0,102.0,109.0,10.0,9,1229,1176,433,287,285,2,743,518,466,52,1176,53207,0.4191,40.8,1418,2465,2228,25,18,0,46,148,"Rawlins County, Kansas",20,153,20153
7808.0,486.0,254.0,21.0,0,3293,3101,1162,675,668,7,1939,1553,1497,56,3101,50213,0.4384,40.0,3743,7708,6808,25,29,1,0,845,"Anderson County, Kansas",20,003,20003
6193.0,410.0,136.0,8.0,10,2677,2388,880,474,465,9,1508,1141,1058,83,2388,54902,0.3936,39.6,3237,5340,5017,24,5,0,19,275,"Ellsworth County, Kansas",20,053,20053
33110.0,1966.0,3326.0,896.0,26,17012,12684,1978,1159,1145,14,10706,8543,7940,603,12684,53133,0.3699,44.2,15344,28576,24998,1061,589,87,196,1645,"Geary County, Kansas",20,061,20061
33698.0,1584.0,705.0,285.0,18,16564,11344,2412,1370,1328,42,8932,7385,6855,530,11344,51711,0.4126,40.7,12268,33657,22796,1976,4099,262,2415,2109,"Ford County, Kansas",20,057,20057
6908.0,448.0,95.0,9.0,4,3038,3015,1006,671,620,51,2009,1414,1259,155,3015,44792,0.4309,39.8,3878,6833,6091,17,19,7,107,592,"Russell County, Kansas",20,167,20167
9637.0,243.0,157.0,19.0,4,4818,4085,1429,767,729,38,2656,1990,1844,146,4085,51895,0.4138,40.4,4918,9575,8891,58,43,0,9,574,"Marshall County, Kansas",20,117,20117
12429.0,543.0,295.0,14.0,82,5823,5372,1752,1094,1058,36,3620,2591,2204,387,5372,45333,0.4205,39.8,6318,12353,11559,86,72,4,0,632,"Allen County, Kansas",20,001,20001
2647.0,30.0,72.0,0.0,0,1257,1221,513,208,197,11,708,511,479,32,1221,47639,0.4345,40.9,1504,2630,2353,20,29,0,65,163,"Cheyenne County, Kansas",20,023,20023
34898.0,1255.0,989.0,386.0,14,15148,13499,4349,2379,2229,150,9150,7118,6660,458,13499,50102,0.4184,39.2,16168,34140,29968,645,352,64,208,2903,"Cowley County, Kansas",20,035,20035
2506.0,75.0,76.0,2.0,0,951,1128,542,312,304,8,586,431,400,31,1128,38750,0.4583,37.9,1762,2501,2254,12,8,0,1,226,"Elk County, Kansas",20,049,20049
25290.0,895.0,470.0,26.0,13,12581,10118,2891,1849,1725,124,7227,5572,5065,507,10118,56582,0.4034,40.5,11246,25359,23104,235,164,0,47,1809,"Franklin County, Kansas",20,059,20059
1869.0,96.0,30.0,8.0,0,985,767,289,164,161,3,478,403,384,19,767,61211,0.385,44.0,975,1844,1634,9,43,0,36,122,"Hodgeman County, Kansas",20,083,20083
2846.0,35.0,10.0,9.0,11,1172,1380,600,346,328,18,780,541,518,23,1380,40676,0.4936,39.8,2025,2854,2605,9,9,0,19,212,"Jewell County, Kansas",20,089,20089
9537.0,514.0,265.0,26.0,13,4629,3917,1196,667,627,40,2721,2069,1951,118,3917,53012,0.4242,39.8,4590,9445,8536,91,190,0,163,465,"Rice County, Kansas",20,159,20159
4155.0,157.0,69.0,0.0,1,1995,1771,608,308,297,11,1163,962,896,66,1771,49375,0.4456,41.9,2345,4064,3485,65,65,45,44,360,"Stafford County, Kansas",20,185,20185
15690.0,928.0,244.0,9.0,4,7218,6607,2160,1300,1291,9,4447,3463,3155,308,6607,54090,0.4246,39.2,7595,15655,14120,62,27,0,0,1446,"Osage County, Kansas",20,139,20139
8161.0,550.0,178.0,3.0,20,3934,3585,1182,726,702,24,2403,2003,1779,224,3585,59583,0.4229,40.6,4102,8154,7481,24,7,0,0,642,"Coffey County, Kansas",20,031,20031
38388.0,1682.0,1840.0,480.0,11,18343,15284,4020,2315,2208,107,11264,8374,6937,1437,15284,41004,0.4629,37.7,18141,38330,33521,345,630,200,218,3416,"Crawford County, Kansas",20,037,20037
6023.0,220.0,30.0,8.0,7,2863,2769,1046,633,608,25,1723,1195,1138,57,2769,41982,0.4585,42.2,4039,5984,5451,36,26,0,0,471,"Greenwood County, Kansas",20,073,20073
166151.0,5164.0,1947.0,196.0,683,86353,60758,18767,12336,11863,473,41991,35765,33344,2421,60758,96769,0.4003,38.9,63564,165607,155183,3788,1815,147,680,3994,"Carroll County, Maryland",24,013,24013
49167.0,2583.0,723.0,98.0,494,25089,18577,6288,4310,4113,197,12289,10054,9415,639,18577,97034,0.4181,40.0,21184,49140,45191,988,580,116,535,1730,"Queen Anne's County, Maryland",24,035,24035
110890.0,4089.0,3680.0,535.0,945,56117,40552,9677,6339,5975,364,30875,24330,22534,1796,40552,89845,0.4029,38.7,45109,109466,99247,2809,1794,117,819,4680,"St. Mary's County, Maryland",24,037,24037
157332.0,5200.0,3349.0,511.0,4579,81351,56520,13731,9802,9354,448,42789,33853,31886,1967,56520,100003,0.3848,39.7,60452,156092,140986,5922,3267,136,643,5138,"Charles County, Maryland",24,017,24017
31746.0,938.0,398.0,26.0,112,14461,13183,4713,2765,2607,158,8470,6428,5934,494,13183,52917,0.471,39.2,16747,31732,29168,435,412,70,303,1344,"Dorchester County, Maryland",24,019,24019
148572.0,5422.0,2945.0,623.0,1117,67470,56035,17770,10817,10284,533,38265,29745,27221,2524,56035,60860,0.4445,38.7,61506,141797,127746,3937,2077,199,1050,6788,"Washington County, Maryland",24,043,24043
101576.0,3587.0,3436.0,536.0,333,48291,37793,11384,7138,6563,575,26409,20572,17629,2943,37793,56956,0.4383,37.6,42382,101218,89159,2704,2670,349,2658,3678,"Wicomico County, Maryland",24,045,24045
101811.0,2146.0,3561.0,289.0,707,50376,37058,10531,7078,6658,420,26527,21251,19308,1943,37058,76887,0.4137,39.2,42658,101525,94494,1845,1047,144,695,3300,"Cecil County, Maryland",24,015,24015
32684.0,1261.0,384.0,49.0,116,15729,12024,3630,2372,2264,108,8394,7030,6302,728,12024,58638,0.4462,39.3,13588,32682,29755,457,651,59,512,1248,"Caroline County, Maryland",24,011,24011
787701.0,32063.0,30540.0,14759.0,140557,433158,309844,70584,36478,33822,2656,239260,163381,120139,43242,309844,69669,0.5327,38.5,337251,790089,541340,108286,110349,3380,12619,14115,"Suffolk County, Massachusetts",25,025,25025
17228.0,125.0,224.0,5.0,96,8372,6765,2748,1678,1525,153,4017,2787,2468,319,6765,71811,0.499,38.5,17902,17213,14794,915,598,183,227,496,"Dukes County, Massachusetts",25,007,25007
1584372.0,41262.0,41757.0,23803.0,109309,874163,604384,169947,104851,99449,5402,434437,341538,291476,50062,604384,102603,0.4638,38.6,636543,1586008,1225311,165100,156196,4098,15195,20108,"Middlesex County, Massachusetts",25,017,25017
555810.0,13704.0,7440.0,2154.0,7733,279379,217912,65539,39784,37460,2324,152373,117557,106233,11324,217912,69095,0.4579,37.5,235275,555111,472468,44859,22304,917,3084,11479,"Bristol County, Massachusetts",25,005,25005
463072.0,7641.0,7176.0,2541.0,4249,214519,179423,55773,32201,30105,2096,123650,92708,84082,8626,179423,55429,0.4731,37.2,193586,462644,410959,23673,13500,907,1629,11976,"Hampden County, Massachusetts",25,013,25013
775707.0,17087.0,9697.0,6493.0,23035,400638,294202,92683,56658,53425,3233,201519,156569,143010,13559,294202,79263,0.4816,37.7,312992,776718,627450,71122,54568,2414,6937,14227,"Essex County, Massachusetts",25,009,25009
69963.0,2280.0,919.0,249.0,799,35848,30569,10686,6328,5771,557,19883,14475,11958,2517,30569,60950,0.4541,37.1,34134,69805,64994,1810,1554,71,98,1278,"Franklin County, Massachusetts",25,011,25011
816807.0,15742.0,12579.0,5704.0,8153,413877,309951,88414,53252,50313,2939,221537,171198,152332,18866,309951,74679,0.4551,38.0,335104,813041,699546,52609,40562,1432,4588,14304,"Worcester County, Massachusetts",25,027,25027
159929.0,10820.0,5670.0,1890.0,2461,81876,58838,19054,11809,11035,774,39784,29311,23675,5636,58838,70876,0.4532,34.1,63873,159678,142816,6320,6977,154,681,2730,"Hampshire County, Massachusetts",25,015,25015
37121.0,2016.0,545.0,123.0,49,15271,13999,4610,2732,2564,168,9389,6720,5983,737,13999,46486,0.4752,37.3,21443,34630,31552,457,378,7,185,2051,"Chippewa County, Michigan",26,033,26033
148301.0,3528.0,2481.0,243.0,163,68933,59929,18556,11694,11296,398,41373,31964,29668,2296,59929,62203,0.4203,39.0,64370,148820,139544,1929,1166,244,147,5790,"Monroe County, Michigan",26,115,26115
1239491.0,38002.0,16870.0,11328.0,2624,634862,504585,145484,87943,84297,3646,359101,266989,239261,27728,504585,79698,0.4687,39.1,539742,1246756,1042145,80236,69455,3861,8414,42645,"Oakland County, Michigan",26,125,26125
45113.0,1543.0,1233.0,45.0,47,18989,18107,6004,3836,3606,230,12103,9179,8430,749,18107,49622,0.4339,38.5,21960,45328,41899,218,216,12,67,2916,"Hillsdale County, Michigan",26,059,26059
171426.0,7214.0,1841.0,356.0,339,74646,65939,20199,12510,11911,599,45740,35777,32051,3726,65939,50854,0.4391,37.8,74092,168479,157440,1570,1158,115,268,7928,"Muskegon County, Michigan",26,121,26121
21375.0,953.0,533.0,43.0,57,9713,9139,4337,2783,2709,74,4802,3817,3558,259,9139,65249,0.4569,37.7,15638,21495,19840,295,253,75,23,1009,"Leelanau County, Michigan",26,089,26089
87114.0,4017.0,578.0,183.0,157,39256,33700,10576,7194,7013,181,23124,18711,17273,1438,33700,62641,0.419,39.0,36674,86468,78595,826,782,55,465,5745,"Lapeer County, Michigan",26,087,26087
40928.0,1370.0,240.0,97.0,64,17461,17499,5998,3733,3573,160,11501,8736,7945,791,17499,47672,0.431,40.0,23086,40956,36715,295,294,60,78,3514,"Sanilac County, Michigan",26,151,26151
2096.0,129.0,32.0,4.0,1,802,1081,511,330,320,10,570,461,430,31,1081,50292,0.4572,36.7,2483,2106,1920,13,19,0,3,151,"Keweenaw County, Michigan",26,083,26083
5848.0,59.0,89.0,13.0,12,2019,2793,1400,889,816,73,1393,894,803,91,2793,41546,0.3986,36.2,5688,5821,5311,65,29,0,5,411,"Ontonagon County, Michigan",26,131,26131
283301.0,16719.0,4459.0,807.0,1094,145652,102610,28753,18114,17628,486,73857,61977,55695,6282,102610,69314,0.4163,37.3,109060,285197,260554,8304,5426,309,1692,8912,"Ottawa County, Michigan",26,139,26139
10295.0,460.0,100.0,17.0,5,3272,4988,2539,1587,1507,80,2449,1763,1562,201,4988,40484,0.4286,37.6,11188,10261,9684,70,32,0,6,469,"Alcona County, Michigan",26,001,26001
63533.0,3333.0,303.0,47.0,124,28293,22964,6420,4123,3912,211,16544,13299,12074,1225,22964,57043,0.3857,38.7,24967,60621,56187,522,300,20,99,3493,"Ionia County, Michigan",26,067,26067
17382.0,952.0,99.0,33.0,25,7207,7145,2526,1611,1519,92,4619,3671,3318,353,7145,46898,0.4251,38.7,12370,17528,15672,89,62,6,98,1601,"Kalkaska County, Michigan",26,079,26079
152677.0,3235.0,4968.0,692.0,502,70292,63665,21421,12892,12065,827,42244,31595,28793,2802,63665,50795,0.4842,38.0,77514,153075,135232,3358,3873,307,1141,9164,"Berrien County, Michigan",26,021,26021
20717.0,1096.0,177.0,38.0,14,7448,9184,3698,2368,2171,197,5486,4083,3696,387,9184,40373,0.4376,38.0,16192,20587,19043,119,93,0,40,1292,"Ogemaw County, Michigan",26,129,26129
32892.0,1884.0,430.0,36.0,63,13790,12963,4390,2818,2708,110,8573,6699,6110,589,12963,47193,0.4537,38.5,16960,33062,30457,236,122,20,23,2204,"Wexford County, Michigan",26,165,26165
13757.0,742.0,188.0,42.0,27,5398,6141,2400,1561,1491,70,3741,2915,2552,363,6141,47977,0.4154,38.0,11193,13708,12675,168,100,0,0,765,"Crawford County, Michigan",26,039,26039
25120.0,393.0,349.0,7.0,13,11021,11231,3866,2360,2258,102,7365,5430,4985,445,11231,51645,0.4356,38.3,14070,25131,23702,207,134,0,3,1085,"Dickinson County, Michigan",26,043,26043
31008.0,885.0,241.0,41.0,79,13555,13847,5246,3092,2987,105,8601,6163,5685,478,13847,48289,0.4329,40.1,21281,30985,28684,275,163,13,31,1819,"Huron County, Michigan",26,063,26063
287289.0,22596.0,6904.0,2635.0,5031,139467,112840,27932,15300,14468,832,84908,59028,46362,12666,112840,52872,0.4731,36.0,123570,288850,246862,10389,15521,1011,1836,13231,"Ingham County, Michigan",26,065,26065
28738.0,1128.0,311.0,60.0,15,12626,12186,4669,2774,2665,109,7517,5709,5087,622,12186,51725,0.4634,38.3,17536,28669,26342,339,208,20,51,1709,"Mason County, Michigan",26,105,26105
22921.0,464.0,628.0,34.0,22,10668,10627,3817,2170,2092,78,6810,4693,4249,444,10627,46828,0.4387,38.7,14342,22772,21485,148,83,15,27,1014,"Menominee County, Michigan",26,109,26109
14852.0,679.0,178.0,24.0,9,6177,6055,2012,1312,1268,44,4043,3195,2895,300,6055,47194,0.3977,40.0,9227,14924,13542,58,62,12,62,1188,"Missaukee County, Michigan",26,113,26113
60063.0,1549.0,1493.0,53.0,167,27394,24150,7597,4784,4502,282,16553,13021,11904,1117,24150,52086,0.4217,39.4,27920,60301,53800,583,884,34,602,4398,"St. Joseph County, Michigan",26,149,26149
74501.0,3353.0,1326.0,255.0,79,34157,29411,9388,5964,5670,294,20023,15808,14710,1098,29411,54485,0.4391,39.1,37255,74775,66186,1074,1436,306,1095,4678,"Van Buren County, Michigan",26,159,26159
14943.0,840.0,81.0,16.0,23,5779,6571,2556,1594,1509,85,4015,2952,2642,310,6571,42290,0.4168,38.1,9836,14935,13867,121,50,0,2,895,"Arenac County, Michigan",26,011,26011
59878.0,2221.0,473.0,152.0,57,28672,24296,7534,4999,4623,376,16762,13591,12578,1013,24296,64490,0.4094,39.3,27586,60161,56757,475,429,0,92,2408,"Barry County, Michigan",26,015,26015
11038.0,167.0,201.0,3.0,6,4338,5225,2249,1212,1141,71,2976,1998,1847,151,5225,41599,0.4293,38.6,9325,10861,9994,89,54,1,3,720,"Iron County, Michigan",26,071,26071
17400.0,567.0,309.0,18.0,91,7741,6792,2904,1992,1890,102,3888,2916,2636,280,6792,57974,0.4119,38.4,12524,17430,16186,239,82,0,11,912,"Benzie County, Michigan",26,019,26019
7986.0,323.0,63.0,24.0,27,2964,3468,1433,858,794,64,2035,1483,1370,113,3468,45500,0.4262,38.1,6385,7940,7442,28,5,0,6,459,"Schoolcraft County, Michigan",26,153,26153
1734785.0,34860.0,19453.0,8455.0,19651,728708,682282,196649,111792,106114,5678,485633,338362,307216,31146,682282,47301,0.4978,38.2,815102,1744974,1499193,82617,53674,5955,16759,86776,"Wayne County, Michigan",26,163,26163
91389.0,4294.0,1735.0,86.0,587,46395,37319,12046,7552,7105,447,25273,19608,17174,2434,37319,63575,0.448,38.1,43942,90808,82897,1057,959,70,330,5495,"Grand Traverse County, Michigan",26,055,26055
10722.0,527.0,184.0,149.0,59,4436,5269,2019,1323,1241,82,3250,2279,1931,348,5269,47938,0.4377,39.6,11168,10663,9339,101,117,10,128,968,"Mackinac County, Michigan",26,097,26097
403363.0,9459.0,3992.0,689.0,2449,169036,167902,51280,30320,28727,1593,116622,85549,77728,7821,167902,48588,0.4629,38.1,192290,405671,374096,6371,2936,306,555,21407,"Genesee County, Michigan",26,049,26049
19852.0,560.0,350.0,21.0,27,9386,8176,2562,1463,1432,31,5614,4360,4146,214,8176,47643,0.4259,39.6,10058,19780,17506,70,31,2,6,2165,"Labette County, Kansas",20,099,20099
506586.0,9922.0,12845.0,2422.0,1372,248651,197229,52075,30443,29425,1018,145154,105788,95600,10188,197229,56524,0.4525,39.0,219116,507552,422256,17169,13937,2601,9886,41703,"Sedgwick County, Kansas",20,173,20173
4625.0,63.0,103.0,0.0,6,2246,2218,864,446,443,3,1354,937,901,36,2218,47976,0.4124,40.9,2873,4570,4294,22,21,0,16,217,"Republic County, Kansas",20,157,20157
2473.0,55.0,28.0,0.0,2,1212,1196,488,254,254,0,708,513,474,39,1196,46375,0.4035,40.0,1479,2490,2271,0,18,0,13,188,"Graham County, Kansas",20,065,20065
119125.0,7550.0,5798.0,1435.0,1379,67000,46936,9975,5977,5715,262,36961,27092,19640,7452,46936,59435,0.4741,35.9,50345,119524,103837,2743,4399,120,1274,7151,"Douglas County, Kansas",20,045,20045
2447.0,100.0,68.0,49.0,0,1292,1134,411,252,241,11,723,538,503,35,1134,62885,0.4401,43.3,1250,2477,2177,23,23,0,18,236,"Sheridan County, Kansas",20,179,20179
5958.0,308.0,109.0,15.0,0,3115,2151,563,303,296,7,1588,1333,1286,47,2151,64930,0.389,41.4,2444,5954,4791,141,224,33,297,468,"Gray County, Kansas",20,069,20069
9957.0,132.0,120.0,42.0,41,2410,2700,587,392,375,17,2113,1631,1539,92,2700,24331,0.5473,39.6,3195,10135,6872,10,189,0,1,3063,"Todd County, South Dakota",46,121,46121
14087.0,161.0,154.0,0.0,61,3367,2729,724,539,481,58,2005,1731,1696,35,2729,31997,0.5128,37.6,3646,14316,9052,28,9,0,13,5214,"Oglala Lakota County, South Dakota",46,102,46102
21594.0,430.0,850.0,87.0,43,8324,8877,3422,2354,2139,215,5455,4006,3501,505,8877,55773,0.4544,39.1,10424,21679,18752,633,799,29,377,1089,"Klickitat County, Washington",53,039,53039
72207.0,4272.0,1592.0,91.0,267,27749,28722,10716,6745,6360,385,18006,13415,11754,1661,28722,51240,0.4463,37.9,36273,69846,62352,1499,904,133,748,4210,"Grays Harbor County, Washington",53,027,53027
4246.0,146.0,56.0,0.0,22,1303,1897,923,660,629,31,974,770,695,75,1897,53227,0.4427,39.3,2149,4225,3794,113,74,0,14,230,"Wahkiakum County, Washington",53,069,53069
93997.0,3381.0,1647.0,467.0,260,40176,30818,8945,5840,5400,440,21873,18093,16682,1411,30818,55556,0.4212,40.0,37476,94973,72895,3980,6068,394,7245,4391,"Grant County, Washington",53,025,53025
789233.0,30611.0,17567.0,5485.0,22065,404749,293823,74642,48076,45013,3063,219181,178439,158103,20336,293823,86691,0.4045,38.7,310127,788537,630734,63384,46581,3559,13984,30295,"Snohomish County, Washington",53,061,53061
12738.0,403.0,446.0,12.0,0,4125,5566,2224,1257,1174,83,3342,2569,2512,57,5566,38187,0.4209,39.0,7705,11963,11522,30,19,0,0,392,"Summers County, West Virginia",54,089,54089
34826.0,844.0,659.0,64.0,14,13684,15188,5651,3350,3215,135,9537,6863,6153,710,15188,40200,0.4589,39.3,19270,34594,32454,178,188,10,48,1716,"Greenbrier County, West Virginia",54,025,54025
26709.0,340.0,540.0,3.0,102,11339,10916,3918,2360,2301,59,6998,5333,4962,371,10916,49936,0.4147,38.5,13139,26941,25110,95,64,31,17,1624,"Mineral County, West Virginia",54,057,54057
15967.0,668.0,169.0,0.0,0,6034,6574,2205,1538,1448,90,4369,3236,2927,309,6574,39908,0.4722,40.2,7966,15957,14855,42,33,0,84,943,"Lewis County, West Virginia",54,041,54041
8362.0,162.0,192.0,4.0,17,3250,3530,1509,844,815,29,2021,1497,1366,131,3530,41882,0.4773,39.2,8924,8169,7563,61,24,0,12,509,"Pocahontas County, West Virginia",54,075,54075
28624.0,1314.0,458.0,12.0,21,11096,11135,4163,2495,2432,63,6972,4983,4491,492,11135,43320,0.4935,39.0,14250,27139,24971,49,99,0,7,2013,"Randolph County, West Virginia",54,083,54083
5762.0,155.0,27.0,0.0,0,2161,2505,903,532,510,22,1602,1235,1120,115,2505,46048,0.4002,40.7,3317,5798,5477,11,0,0,0,310,"Wirt County, West Virginia",54,105,54105
8536.0,140.0,73.0,0.0,22,2472,3274,1204,893,890,3,2070,1645,1398,247,3274,35024,0.4416,38.7,4638,8663,8359,0,0,0,0,304,"Clay County, West Virginia",54,015,54015
104264.0,4823.0,6078.0,1090.0,1326,50206,39466,8536,5268,5090,178,30930,20870,15645,5225,39466,52455,0.5257,37.1,44957,103950,93622,1733,3566,68,544,4417,"Monongalia County, West Virginia",54,061,54061
15261.0,369.0,234.0,20.0,5,5458,5762,2420,1566,1481,85,3342,2552,2204,348,5762,43107,0.4204,39.2,8159,15335,14366,45,6,0,0,918,"Wetzel County, West Virginia",54,103,54103
181251.0,4290.0,2601.0,365.0,1700,77599,79070,26998,16012,15448,564,52072,36725,33050,3675,79070,46639,0.4837,39.1,92409,181327,167649,2021,1121,77,236,10223,"Kanawha County, West Virginia",54,039,54039
33318.0,770.0,807.0,166.0,61,13022,12429,4487,2993,2746,247,7942,6416,5843,573,12429,51888,0.4291,39.5,15121,30800,28801,54,28,0,43,1874,"Preston County, West Virginia",54,077,54077
9764.0,497.0,173.0,2.0,9,3483,4049,1568,908,885,23,2481,2049,1917,132,4049,43577,0.4725,40.6,5898,9791,8838,49,56,1,0,847,"Ritchie County, West Virginia",54,085,54085
20613.0,143.0,214.0,34.0,24,6809,8208,2860,1903,1883,20,5348,4280,4038,242,8208,42345,0.4481,39.2,9937,20791,19484,9,24,0,21,1253,"Lincoln County, West Virginia",54,043,54043
14108.0,541.0,115.0,8.0,0,5112,5624,2150,1571,1472,99,3474,2746,2605,141,5624,41466,0.4375,40.2,7426,13834,13076,0,6,0,3,749,"Braxton County, West Virginia",54,007,54007
22160.0,468.0,199.0,17.0,0,6307,8932,3127,2094,1953,141,5805,4571,4194,377,8932,40739,0.4386,41.4,11199,22246,20926,45,13,0,0,1262,"Boone County, West Virginia",54,005,54005
21138.0,229.0,95.0,0.0,28,5858,8805,3278,2366,2319,47,5527,4484,4296,188,8805,42332,0.452,40.9,10904,21205,19933,69,24,0,0,1179,"Wyoming County, West Virginia",54,109,54109
44337.0,2931.0,2088.0,57.0,24,22977,16859,4786,2791,2609,182,12073,9282,7760,1522,16859,58783,0.4171,36.9,18463,44412,40850,448,568,191,160,2195,"Dunn County, Wisconsin",55,033,55033
51209.0,2941.0,1165.0,69.0,59,25687,19583,5742,3284,3128,156,13841,10804,8911,1893,19583,54800,0.4089,38.7,22076,50596,46801,310,372,44,138,2931,"Grant County, Wisconsin",55,043,55043
113945.0,2186.0,1275.0,345.0,197,58620,47738,14343,8324,7949,375,33395,25075,22756,2319,47738,60696,0.4092,39.0,51075,112935,102704,3931,1759,42,725,3774,"Sheboygan County, Wisconsin",55,117,55117
4480.0,187.0,5.0,0.0,33,1464,1408,473,334,321,13,935,777,718,59,1408,40921,0.5069,35.2,2361,4527,3398,0,7,0,0,1122,"Menominee County, Wisconsin",55,078,55078
12992.0,581.0,257.0,6.0,11,6721,5772,1966,1242,1164,78,3806,2956,2647,309,5772,57829,0.4097,40.5,6788,13055,12254,75,44,0,67,615,"Buffalo County, Wisconsin",55,011,55011
116704.0,6169.0,3263.0,199.0,505,61648,47518,13031,7580,7240,340,34487,25608,20262,5346,47518,57882,0.4551,37.1,50304,116551,108024,2493,987,29,96,4922,"La Crosse County, Wisconsin",55,063,55063
133870.0,4222.0,1708.0,325.0,291,70554,55466,16256,10147,9601,546,39210,30769,27528,3241,55466,62633,0.4412,39.6,59335,134385,122188,2905,1319,209,893,6871,"Marathon County, Wisconsin",55,073,55073
29095.0,1123.0,325.0,26.0,20,14862,12005,3610,2104,1975,129,8395,6407,5713,694,12005,58548,0.3993,40.7,13138,29128,26375,343,293,44,609,1464,"Trempealeau County, Wisconsin",55,121,55121
86942.0,4193.0,1053.0,236.0,49,44569,34980,10160,6089,5718,371,24820,19286,17320,1966,34980,60652,0.3967,39.6,37805,83913,79421,665,705,15,462,2645,"Dodge County, Wisconsin",55,027,55027
21586.0,740.0,451.0,5.0,6,9143,10921,4642,2904,2757,147,6279,4597,4141,456,10921,47072,0.4776,38.1,25921,21549,19865,227,96,7,13,1341,"Vilas County, Wisconsin",55,125,55125
78612.0,1507.0,845.0,184.0,229,40183,34563,10831,6015,5762,253,23732,17585,15780,1805,34563,56612,0.4041,39.6,37486,78768,73726,988,702,71,504,2777,"Manitowoc County, Wisconsin",55,071,55071
15197.0,288.0,532.0,10.0,20,6542,7305,2948,1967,1843,124,4357,3284,2912,372,7305,52672,0.4193,38.1,15597,15183,13980,117,45,5,13,1023,"Burnett County, Wisconsin",55,013,55013
27215.0,782.0,588.0,99.0,57,13535,13191,5396,3547,3447,100,7795,6184,5634,550,13191,61560,0.439,39.5,24857,27134,25426,383,281,47,125,872,"Door County, Wisconsin",55,029,55029
101603.0,4469.0,1140.0,366.0,115,53174,41542,12471,7336,6923,413,29071,22427,20308,2119,41542,62391,0.4101,39.1,45206,100864,94047,939,1910,68,530,3370,"Fond du Lac County, Wisconsin",55,039,55039
7214.0,161.0,91.0,14.0,2,3645,3070,1092,637,599,38,1978,1515,1404,111,3070,54583,0.4238,40.8,3663,7191,6572,40,23,0,36,520,"Pepin County, Wisconsin",55,091,55091
17294.0,665.0,209.0,118.0,66,8177,7538,2692,1633,1518,115,4846,3681,3289,392,7538,51947,0.4133,39.6,8982,17324,15696,141,73,18,196,1200,"Richland County, Wisconsin",55,103,55103
23997.0,1297.0,363.0,17.0,4,10429,9934,3888,2470,2355,115,6046,4658,4370,288,9934,52810,0.4311,39.3,15113,22954,20791,285,169,48,168,1493,"Waushara County, Wisconsin",55,137,55137
16522.0,670.0,170.0,7.0,8,8488,6722,2122,1274,1228,46,4600,3671,3321,350,6722,60691,0.4042,42.1,7310,16631,14926,50,171,40,150,1294,"Lafayette County, Wisconsin",55,065,55065
41513.0,2254.0,2712.0,271.0,32,23061,15593,4126,2708,2601,107,11467,8992,7555,1437,15593,72323,0.3938,37.4,16599,41687,39038,226,495,21,142,1765,"Pierce County, Wisconsin",55,093,55093
49245.0,1994.0,338.0,98.0,85,27356,19807,4957,3138,3032,106,14850,12363,11627,736,19807,75814,0.3983,39.7,20712,49764,47145,818,178,55,228,1340,"Calumet County, Wisconsin",55,015,55015
166669.0,3870.0,6520.0,511.0,1025,84301,64111,16361,9339,8949,390,47750,37089,32907,4182,64111,63733,0.4355,38.4,70441,166531,147567,5119,3178,236,2035,8396,"Kenosha County, Wisconsin",55,059,55059
8423.0,214.0,347.0,33.0,14,4109,3845,1367,910,886,24,2478,1697,1613,84,3845,58132,0.495,44.0,4620,8393,7233,26,41,10,17,1066,"Johnson County, Wyoming",56,019,56019
1546.0,47.0,11.0,2.0,4,757,636,244,146,146,0,392,308,306,2,636,63269,0.3566,44.0,781,1549,1423,32,2,0,27,65,"Wallace County, Kansas",20,199,20199
2620.0,132.0,5.0,6.0,0,1102,1051,445,232,220,12,606,456,434,22,1051,45353,0.4056,38.1,1494,2548,2242,22,19,0,0,265,"Chase County, Kansas",20,017,20017
5594.0,88.0,344.0,0.0,0,2475,1814,541,344,314,30,1273,1085,1022,63,1814,57806,0.4621,42.1,2329,5480,3991,149,341,48,556,395,"Stevens County, Kansas",20,189,20189
3599.0,157.0,35.0,3.0,1,1691,1701,656,380,375,5,1045,830,737,93,1701,43429,0.4458,39.7,2244,3567,3226,6,29,0,0,306,"Smith County, Kansas",20,183,20183
7406.0,111.0,124.0,0.0,16,3424,2551,665,442,442,0,1886,1488,1365,123,2551,53413,0.4129,41.9,2961,7345,5600,300,324,38,495,588,"Grant County, Kansas",20,067,20067
23005.0,1234.0,333.0,53.0,43,9835,9899,4164,2901,2794,107,5735,4554,4135,419,9899,56165,0.4561,38.7,18069,23031,21301,219,102,6,76,1327,"Antrim County, Michigan",26,009,26009
35718.0,1884.0,1053.0,366.0,34,14666,13386,4202,2354,2310,44,9184,6398,5088,1310,13386,43183,0.4736,35.2,18798,35650,31734,450,953,23,189,2301,"Houghton County, Michigan",26,061,26061
187626.0,6625.0,1891.0,326.0,261,96531,72000,21463,14497,13915,582,50537,41314,38238,3076,72000,84221,0.4071,39.1,76321,188829,177087,3324,1599,321,199,6299,"Livingston County, Michigan",26,093,26093
25013.0,895.0,676.0,65.0,17,8964,11669,5175,3171,2912,259,6494,4649,4162,487,11669,43678,0.4112,38.3,20558,24874,22762,259,208,21,122,1502,"Iosco County, Michigan",26,069,26069
11758.0,841.0,149.0,9.0,23,3806,4631,2164,1329,1232,97,2467,1689,1492,197,4631,37320,0.4322,37.7,15347,11541,10644,87,86,0,18,706,"Lake County, Michigan",26,085,26085
24333.0,1204.0,451.0,77.0,104,9435,9426,4134,2542,2443,99,5292,3813,3513,300,9426,50055,0.4365,37.8,15848,23218,21534,146,187,14,33,1304,"Manistee County, Michigan",26,101,26101
13129.0,605.0,174.0,24.0,13,6041,5465,1724,1162,1142,20,3741,2884,2647,237,5465,57914,0.3962,38.9,5859,13128,12261,86,40,0,44,697,"Jackson County, Kansas",20,085,20085
7245.0,270.0,131.0,3.0,1,3520,3133,1151,587,576,11,1982,1620,1559,61,3133,60469,0.4417,40.4,3847,7218,6728,23,55,0,0,412,"Kingman County, Kansas",20,095,20095
2777.0,117.0,71.0,0.0,0,1429,1153,368,220,220,0,785,562,528,34,1153,51740,0.4407,41.0,1442,2765,2524,18,39,0,0,184,"Logan County, Kansas",20,109,20109
9981.0,430.0,75.0,9.0,39,5249,4007,1262,737,716,21,2745,2162,2022,140,4007,63216,0.4073,39.3,4600,9847,9301,43,18,5,12,468,"Nemaha County, Kansas",20,131,20131
23570.0,1398.0,718.0,32.0,1,11336,8698,2248,1414,1402,12,6450,5211,4952,259,8698,66835,0.3979,40.0,9649,23357,21802,145,228,41,125,1016,"Pottawatomie County, Kansas",20,149,20149
162410.0,5140.0,5333.0,747.0,719,75197,60128,14415,8492,8051,441,45713,33287,30168,3119,60128,46881,0.4246,39.0,68095,163593,120641,4791,8652,1048,13208,15253,"Wyandotte County, Kansas",20,209,20209
19997.0,399.0,720.0,8.0,1,8470,7929,2721,1420,1375,45,5208,4102,3809,293,7929,43175,0.4102,39.0,9875,19992,17506,62,129,0,33,2262,"Cherokee County, Kansas",20,021,20021
66100.0,2891.0,1257.0,200.0,65,30594,24870,7141,4074,3949,125,17729,14813,13935,878,24870,64782,0.4158,38.8,26918,64098,57471,868,595,81,228,4855,"Butler County, Kansas",20,015,20015
8018.0,519.0,121.0,22.0,4,3858,3514,1247,715,687,28,2267,1631,1585,46,3514,53929,0.4453,39.4,4101,7863,7166,89,37,0,0,571,"Clay County, Kansas",20,027,20027
3015.0,165.0,25.0,0.0,1,1373,1248,447,253,240,13,801,534,500,34,1248,45076,0.3977,41.3,1853,2982,2712,2,8,0,1,259,"Lincoln County, Kansas",20,105,20105
53940.0,2053.0,1505.0,438.0,238,27202,21959,6449,3610,3404,206,15510,11151,9954,1197,21959,52200,0.437,39.3,24377,53934,46990,1171,1082,312,632,3747,"Saline County, Kansas",20,169,20169
22833.0,961.0,452.0,44.0,0,10461,9416,3164,1700,1600,100,6252,4933,4571,362,9416,55000,0.4151,39.8,10993,22637,20617,160,103,0,0,1757,"Sumner County, Kansas",20,191,20191
2840.0,356.0,26.0,8.0,3,1597,1379,464,297,281,16,915,612,599,13,1379,57966,0.3718,43.9,1669,2753,2480,48,0,0,8,217,"Trego County, Kansas",20,195,20195
6823.0,377.0,65.0,8.0,2,3371,2744,974,556,542,14,1770,1403,1332,71,2744,61178,0.3684,38.9,3294,6787,6359,64,19,0,0,345,"Wabaunsee County, Kansas",20,197,20197
8561.0,400.0,79.0,0.0,19,3881,3712,1344,708,690,18,2368,1840,1684,156,3712,48341,0.4839,38.3,4682,8549,7864,64,23,0,0,598,"Wilson County, Kansas",20,205,20205
6062.0,289.0,98.0,7.0,0,2625,2570,904,514,453,61,1666,1232,1101,131,2570,46203,0.4384,40.5,3292,5999,5480,37,15,26,0,441,"Mitchell County, Kansas",20,123,20123
3481.0,109.0,65.0,2.0,4,1742,1648,571,301,298,3,1077,749,659,90,1648,51286,0.4775,42.2,2180,3430,3129,24,7,0,0,270,"Osborne County, Kansas",20,141,20141
16083.0,465.0,589.0,0.0,1,7667,5958,1936,1025,960,65,4022,3042,2901,141,5958,50439,0.4209,35.3,6961,16091,14866,77,77,0,0,1071,"Atchison County, Kansas",20,005,20005
36128.0,812.0,840.0,63.0,111,18365,12519,2846,1667,1581,86,9673,7823,7298,525,12519,60798,0.3884,40.4,13562,36494,25747,2885,3267,294,1899,2402,"Finney County, Kansas",20,055,20055
2576.0,28.0,121.0,22.0,0,1220,890,212,136,119,17,678,432,422,10,890,46944,0.3439,45.6,1215,2591,1950,66,80,20,240,235,"Hamilton County, Kansas",20,075,20075
79674.0,3795.0,5997.0,627.0,77,37164,27253,7618,4961,4794,167,19635,15495,14775,720,27253,73013,0.4144,39.0,29771,73546,68353,1028,671,23,48,3423,"Leavenworth County, Kansas",20,103,20103
5435.0,95.0,69.0,3.0,2,2622,2332,835,478,466,12,1497,1078,999,79,2332,50588,0.4182,42.1,2932,5364,5021,34,68,0,37,204,"Washington County, Kansas",20,201,20201
2105.0,31.0,25.0,33.0,0,1069,934,260,145,145,0,674,508,483,25,934,57978,0.3615,43.0,1102,2100,1760,54,153,0,81,52,"Wichita County, Kansas",20,203,20203
2739.0,22.0,48.0,9.0,0,1118,1038,357,216,216,0,681,484,406,78,1038,47750,0.4193,41.2,1461,2677,1991,119,138,2,40,387,"Morton County, Kansas",20,129,20129
5408.0,529.0,140.0,0.0,0,2326,1830,732,353,314,39,1098,887,823,64,1830,49038,0.4589,37.7,2542,4592,4230,1,19,14,0,328,"Norton County, Kansas",20,137,20137
26242.0,984.0,269.0,210.0,93,13091,10624,3329,1958,1887,71,7295,5402,4869,533,10624,49723,0.4369,40.3,12733,26071,22234,290,489,73,582,2403,"Barton County, Kansas",20,009,20009
8824.0,466.0,226.0,8.0,19,4305,3689,1183,692,661,31,2506,1872,1688,184,3689,45373,0.444,40.7,4605,8696,7746,79,41,2,50,778,"Cloud County, Kansas",20,029,20029
2853.0,70.0,16.0,0.0,0,1392,1308,426,227,219,8,882,644,621,23,1308,50902,0.3881,43.5,1618,2780,2352,87,157,0,12,172,"Edwards County, Kansas",20,047,20047
1530.0,48.0,7.0,0.0,0,821,757,206,122,120,2,551,311,282,29,757,52125,0.4271,42.9,970,1559,1364,11,6,28,4,146,"Lane County, Kansas",20,101,20101
2976.0,123.0,26.0,5.0,3,1405,1421,531,246,237,9,890,586,526,60,1421,47981,0.4011,42.3,1858,2951,2774,14,3,0,0,160,"Rush County, Kansas",20,165,20165
11861.0,357.0,145.0,36.0,5,5616,4846,1822,1060,1028,32,3024,2399,2170,229,4846,52123,0.4095,39.3,6000,11603,10760,72,25,0,25,721,"Marion County, Kansas",20,115,20115
15856.0,692.0,174.0,39.0,13,7107,6601,2185,1183,1160,23,4416,3362,3188,174,6601,46291,0.4367,39.0,7744,15918,13909,58,24,2,287,1638,"Neosho County, Kansas",20,133,20133
5782.0,174.0,51.0,27.0,9,2857,2446,786,484,480,4,1660,1346,1230,116,2446,54784,0.4098,40.9,2788,5732,5317,25,35,0,0,355,"Ottawa County, Kansas",20,143,20143
74189.0,5753.0,3700.0,1922.0,183,41927,26490,4435,2675,2612,63,22055,15438,11195,4243,26490,51208,0.4747,37.8,30912,68256,58968,1516,3736,126,404,3506,"Riley County, Kansas",20,161,20161
4591.0,120.0,114.0,5.0,8,2092,1923,691,434,411,23,1232,859,778,81,1923,50174,0.4708,40.5,2801,4582,4058,13,40,7,29,435,"Barber County, Kansas",20,007,20007
18609.0,674.0,577.0,118.0,26,8873,7911,2512,1377,1286,91,5399,3919,3709,210,7911,49991,0.4398,39.6,9172,18494,16835,159,75,15,111,1299,"Dickinson County, Kansas",20,041,20041
18648.0,690.0,177.0,7.0,0,9276,7575,2241,1410,1369,41,5334,4438,4040,398,7575,64864,0.3662,39.2,8378,18645,17438,39,48,0,0,1120,"Jefferson County, Kansas",20,087,20087
35188.0,1314.0,740.0,24.0,39,13991,14056,4947,3185,3079,106,9109,7719,7067,652,14056,51655,0.4622,39.1,16319,35132,33175,169,79,0,26,1683,"Greenup County, Kentucky",21,089,21089
14362.0,526.0,98.0,21.0,10,5912,5841,1850,1065,989,76,3991,3367,3211,156,5841,44612,0.4549,40.2,6705,14513,13143,29,24,10,0,1307,"Fleming County, Kentucky",21,069,21069
26805.0,638.0,358.0,163.0,17,8552,9606,3458,1983,1947,36,6148,4867,4657,210,9606,34736,0.4991,37.2,12503,26838,24599,12,69,0,50,2108,"Carter County, Kentucky",21,043,21043
24581.0,1307.0,398.0,23.0,14,10515,9141,2477,1539,1491,48,6664,5664,5266,398,9141,48714,0.4284,39.8,10209,24530,22997,318,11,0,0,1204,"Grant County, Kentucky",21,081,21081
757877.0,13917.0,17269.0,2554.0,10281,375408,312679,87556,50530,47925,2605,225123,157330,138012,19318,312679,56586,0.4755,38.8,345261,759033,670038,24798,24504,2106,8325,29262,"Jefferson County, Kentucky",21,111,21111
26704.0,714.0,602.0,38.0,11,11033,10418,3347,2044,1976,68,7071,5537,5105,432,10418,48014,0.4432,39.9,12363,26563,24422,175,90,30,82,1764,"Logan County, Kentucky",21,141,21141
16937.0,524.0,602.0,252.0,23,7204,6700,2098,1255,1228,27,4602,3454,3227,227,6700,45377,0.5178,39.3,8163,16801,15292,72,108,0,243,1086,"Mason County, Kentucky",21,161,21161
14389.0,844.0,170.0,0.0,42,6376,5253,1544,956,923,33,3709,2959,2852,107,5253,54375,0.425,39.5,6361,14473,13967,84,70,0,0,352,"Pendleton County, Kentucky",21,191,21191
2111.0,77.0,60.0,0.0,0,800,861,276,147,142,5,585,423,352,71,861,41902,0.468,38.9,1080,2059,1897,0,0,0,0,162,"Robertson County, Kentucky",21,201,21201
18440.0,881.0,262.0,55.0,5,9431,6763,1649,1213,1169,44,5114,4555,4295,260,6763,80166,0.3922,39.4,7273,18553,17726,69,55,11,17,675,"Spencer County, Kentucky",21,215,21215
12176.0,376.0,218.0,52.0,0,4602,4827,1450,967,910,57,3377,2839,2613,226,4827,44898,0.4284,39.6,5496,12281,11550,17,27,0,19,668,"Bath County, Kentucky",21,011,21011
7902.0,171.0,248.0,3.0,56,3266,3065,1119,688,664,24,1946,1561,1455,106,3065,45048,0.4549,37.9,3917,7913,7174,110,26,58,5,540,"Ballard County, Kentucky",21,007,21007
29735.0,2266.0,993.0,146.0,46,11781,11023,3747,2010,1920,90,7276,5488,5091,397,11023,46382,0.4771,38.9,12490,28528,26684,248,296,11,179,1110,"Boyle County, Kentucky",21,021,21021
10858.0,616.0,43.0,0.0,37,4378,4413,1597,912,895,17,2816,2162,2020,142,4413,35899,0.4842,39.0,5304,10855,10170,19,45,0,37,584,"Green County, Kentucky",21,087,21087
26450.0,607.0,173.0,20.0,43,6840,11134,3621,2169,2112,57,7513,5701,5335,366,11134,26478,0.4919,38.9,13589,26219,24556,76,60,0,10,1517,"Harlan County, Kentucky",21,095,21095
11508.0,528.0,410.0,22.0,0,3125,4153,1480,946,923,23,2673,2117,1882,235,4153,41013,0.4244,40.0,5280,10377,9731,3,0,0,0,643,"Martin County, Kentucky",21,159,21159
24237.0,1538.0,71.0,19.0,42,9826,9697,3221,1996,1878,118,6476,5254,4902,352,9697,42919,0.4271,39.8,11015,24219,21934,28,34,0,166,2057,"Lincoln County, Kentucky",21,137,21137
10464.0,238.0,84.0,33.0,34,4273,4491,1486,709,698,11,3005,2310,2143,167,4491,34879,0.5106,39.0,5260,10495,9437,38,95,7,82,836,"Monroe County, Kentucky",21,171,21171
23799.0,672.0,262.0,25.0,0,9514,9122,2882,1905,1844,61,6240,5117,4679,438,9122,45564,0.4703,39.6,10386,23716,22177,110,125,0,183,1121,"Ohio County, Kentucky",21,183,21183
14465.0,313.0,1088.0,4.0,0,6044,5374,1604,1088,1079,9,3770,2877,2724,153,5374,46673,0.4122,41.6,6249,14470,13618,58,99,17,24,654,"Union County, Kentucky",21,225,21225
12921.0,459.0,151.0,39.0,5,4822,4953,1533,847,810,37,3420,2604,2504,100,4953,42119,0.4697,40.1,5960,12724,11619,114,208,6,158,619,"Webster County, Kentucky",21,233,21233
40346.0,1128.0,116.0,235.0,0,15712,12987,4082,2823,2727,96,8905,7060,6529,531,12987,41505,0.4945,40.4,16365,40584,31792,880,502,68,848,6494,"Jim Wells County, Texas",48,249,48249
7084.0,247.0,273.0,302.0,0,3622,2364,555,376,370,6,1809,1495,1341,154,2364,58811,0.4676,44.1,2955,7262,4539,272,230,55,1216,950,"Dallam County, Texas",48,111,48111
9215.0,444.0,219.0,16.0,3,2982,4452,2043,1351,1292,59,2409,1674,1498,176,4452,41772,0.3887,39.5,9615,9179,8381,64,25,0,9,700,"Montmorency County, Michigan",26,119,26119
12652.0,373.0,167.0,15.0,4,4557,5797,2648,1798,1719,79,3149,2306,2143,163,5797,47948,0.4352,40.0,10474,12589,11571,100,45,0,33,840,"Presque Isle County, Michigan",26,141,26141
25022.0,1034.0,187.0,21.0,52,8762,11047,4541,2925,2776,149,6506,4690,4309,381,11047,44619,0.4472,37.5,17923,25120,22556,198,39,7,8,2312,"Gladwin County, Michigan",26,051,26051
259866.0,12872.0,6008.0,1732.0,2221,130681,103445,27146,15372,14639,733,76299,56483,46635,9848,103445,56511,0.4672,37.3,112108,260675,234117,5410,6970,269,1068,12841,"Kalamazoo County, Michigan",26,077,26077
42779.0,3696.0,439.0,144.0,88,17956,15808,5257,3329,3117,212,10551,7763,6477,1286,15808,45018,0.4555,36.3,21539,43013,39437,281,451,0,10,2834,"Mecosta County, Michigan",26,107,26107
66205.0,3082.0,1369.0,179.0,132,29906,26552,8488,5285,5040,245,18064,13258,10842,2416,26552,53970,0.4284,36.2,34850,64947,61137,690,428,12,62,2618,"Marquette County, Michigan",26,103,26103
47874.0,1954.0,429.0,48.0,104,19992,19161,6200,3982,3782,200,12961,10120,9300,820,19161,50326,0.4368,38.8,25529,47829,43998,417,396,33,123,2862,"Newaygo County, Michigan",26,123,26123
23039.0,990.0,371.0,26.0,50,8763,9181,3265,2147,2054,93,5916,4396,4089,307,9181,44032,0.4215,39.5,13784,22977,20571,146,46,0,21,2193,"Osceola County, Michigan",26,133,26133
24211.0,1458.0,205.0,18.0,27,10538,9944,3393,2192,2127,65,6551,5261,4710,551,9944,54332,0.4089,38.5,14899,24303,22320,315,50,0,17,1601,"Otsego County, Michigan",26,137,26137
132692.0,4496.0,1897.0,351.0,582,58637,53991,16302,9533,8921,612,37689,27096,24850,2246,53991,48607,0.4437,38.4,60889,132568,120676,2111,2449,110,719,6503,"Calhoun County, Michigan",26,025,26025
25268.0,1164.0,395.0,25.0,91,10379,11195,4702,3016,2835,181,6493,4903,4470,433,11195,48044,0.4211,38.5,18512,25078,22975,220,82,17,39,1745,"Cheboygan County, Michigan",26,031,26031
6278.0,489.0,81.0,14.0,0,2059,2231,872,527,495,32,1359,1002,932,70,2231,45469,0.3958,36.7,4373,5292,4988,22,32,0,6,244,"Luce County, Michigan",26,095,26095
640081.0,21608.0,10037.0,2900.0,6252,329488,241746,60311,36179,34704,1475,181435,142545,125452,17093,241746,63053,0.4569,38.2,255024,643646,562110,20351,23676,1386,9225,26898,"Kent County, Michigan",26,081,26081
189635.0,6401.0,1463.0,405.0,367,81392,78933,25355,14770,14039,731,53578,39998,35710,4288,78933,48000,0.477,37.7,87665,188503,176040,2252,1733,71,524,7883,"Saginaw County, Michigan",26,145,26145
67706.0,2518.0,383.0,39.0,72,31299,27593,8561,5259,4975,284,19032,15372,13834,1538,27593,56032,0.4036,39.0,30224,67937,64040,347,270,13,8,3259,"Shiawassee County, Michigan",26,155,26155
103091.0,3265.0,712.0,159.0,272,46051,44339,14232,8220,7809,411,30107,22515,20251,2264,44339,48819,0.4349,38.0,48289,103211,96599,827,515,24,60,5186,"Bay County, Michigan",26,017,26017
25968.0,1209.0,277.0,20.0,116,12111,11503,4231,2749,2632,117,7272,5340,4819,521,11503,55760,0.464,38.2,17678,25935,23828,222,144,42,53,1646,"Charlevoix County, Michigan",26,029,26029
35725.0,1003.0,495.0,68.0,131,15266,16234,6015,3677,3495,182,10219,7770,7006,764,16234,47434,0.4362,37.4,20367,35643,33238,240,91,31,46,1997,"Delta County, Michigan",26,041,26041
32744.0,1450.0,487.0,43.0,49,16112,14463,4838,3118,2998,120,9625,6894,6129,765,14463,55829,0.4656,38.8,21678,32780,29936,358,188,9,84,2205,"Emmet County, Michigan",26,047,26047
12405.0,254.0,346.0,21.0,25,5758,5538,2024,1223,1155,68,3514,2493,2289,204,5538,50870,0.4302,37.3,7937,12329,11193,430,303,0,0,403,"Koochiching County, Minnesota",27,071,27071
32711.0,1363.0,217.0,33.0,97,16402,13371,4244,2448,2345,103,9127,7197,6676,521,13371,57815,0.4276,39.7,16150,32719,30827,209,89,55,120,1419,"Morrison County, Minnesota",27,097,27097
14050.0,525.0,161.0,7.0,43,7553,5995,1850,976,902,74,4145,3013,2664,349,5995,60122,0.4033,39.7,6542,13971,13325,181,121,8,7,329,"Pennington County, Minnesota",27,113,27113
36236.0,1550.0,807.0,21.0,157,18660,14692,4304,2584,2515,69,10388,7908,7284,624,14692,64903,0.4088,39.3,15628,36295,33457,929,768,22,71,1048,"Steele County, Minnesota",27,147,27147
6214.0,99.0,173.0,3.0,29,3205,2818,824,414,404,10,1994,1488,1429,59,2818,60595,0.4312,39.9,3117,6165,5999,22,2,0,1,141,"Wilkin County, Minnesota",27,167,27167
15735.0,709.0,119.0,19.0,21,6174,7681,3518,2260,2140,120,4163,3048,2789,259,7681,49351,0.4254,39.0,16743,15651,14835,127,51,1,4,633,"Aitkin County, Minnesota",27,001,27001
13648.0,514.0,87.0,23.0,5,6918,6137,2167,1210,1148,62,3970,2896,2654,242,6137,53156,0.4295,39.0,7043,13521,12695,98,71,0,127,530,"Faribault County, Minnesota",27,043,27043
8206.0,276.0,111.0,7.0,9,4127,3645,1437,821,801,20,2208,1686,1558,128,3645,60231,0.4043,40.7,4627,8197,7619,71,179,0,25,303,"Murray County, Minnesota",27,101,27101
42195.0,1170.0,730.0,119.0,292,21666,16889,4994,3109,3022,87,11895,9269,8374,895,16889,60294,0.4348,39.0,19917,42141,36680,1084,1606,130,742,1899,"Kandiyohi County, Minnesota",27,067,27067
10440.0,355.0,128.0,3.0,32,4651,5192,1850,1106,1061,45,3342,2408,2241,167,5192,61452,0.388,38.1,7775,10391,9824,95,37,9,0,426,"Lake County, Minnesota",27,075,27075
9234.0,264.0,421.0,2.0,14,4721,3914,1172,699,692,7,2742,2200,2016,184,3914,63005,0.4168,40.1,4267,9175,8674,87,30,8,22,354,"Rock County, Minnesota",27,133,27133
15192.0,290.0,216.0,20.0,39,8129,5980,1722,1088,1057,31,4258,3265,2947,318,5980,62202,0.397,38.8,7607,15183,14043,369,185,22,11,553,"Roseau County, Minnesota",27,135,27135
3287.0,93.0,122.0,3.0,8,1695,1608,555,313,307,6,1053,762,709,53,1608,51957,0.4088,39.8,2065,3225,3083,39,8,0,16,79,"Traverse County, Minnesota",27,155,27155
33622.0,1006.0,715.0,99.0,89,15938,13617,4566,2948,2812,136,9051,6947,6509,438,13617,60284,0.4489,39.0,19704,33609,31098,261,132,8,14,2096,"Becker County, Minnesota",27,005,27005
1229939.0,41224.0,31508.0,10068.0,48634,684634,508030,121568,67570,63281,4289,386462,272965,228429,44536,508030,78167,0.4817,38.4,533880,1237371,1026029,83226,67998,5410,18246,36462,"Hennepin County, Minnesota",27,053,27053
24846.0,554.0,422.0,27.0,45,13500,10764,3592,2143,2042,101,7172,5489,4962,527,10764,61120,0.3956,38.8,11729,24835,23409,263,262,0,80,821,"Brown County, Minnesota",27,015,27015
11756.0,526.0,263.0,10.0,45,5929,5209,1708,939,899,40,3501,2553,2348,205,5209,55269,0.431,40.6,5713,11760,10440,91,315,40,253,621,"Chippewa County, Minnesota",27,023,27023
8715.0,332.0,102.0,28.0,18,3804,3405,1218,709,689,20,2187,1675,1549,126,3405,50386,0.4577,40.1,4790,8713,7893,37,30,2,18,733,"Clearwater County, Minnesota",27,029,27029
45654.0,2000.0,846.0,147.0,359,23845,19452,6109,3586,3383,203,13343,10458,9424,1034,19452,66800,0.4139,39.4,20616,45408,42141,488,530,48,235,1966,"Goodhue County, Minnesota",27,049,27049
38949.0,2878.0,451.0,36.0,91,20045,14903,4203,2796,2606,190,10700,8590,7573,1017,14903,74616,0.3946,38.9,16007,39113,36928,428,122,2,60,1573,"Isanti County, Minnesota",27,059,27059
9833.0,366.0,164.0,34.0,13,5153,4419,1478,859,832,27,2941,2313,2030,283,4419,58727,0.4378,39.4,5077,9842,9192,155,142,5,30,318,"Jackson County, Minnesota",27,063,27063
39297.0,1521.0,951.0,304.0,353,18855,15565,4936,2759,2633,126,10629,8081,7363,718,15565,54295,0.45,38.7,17071,39323,33431,1056,2266,238,1028,1304,"Mower County, Minnesota",27,099,27099
28972.0,1263.0,374.0,20.0,39,12632,10760,4003,2452,2276,176,6757,4982,4528,454,10760,53422,0.4276,37.4,17596,27679,25786,205,68,0,10,1610,"Pine County, Minnesota",27,115,27115
153098.0,4405.0,4240.0,1501.0,4033,81739,62108,15997,9790,9441,349,46111,34897,31020,3877,62108,76951,0.4505,38.9,65380,153048,131612,7836,7703,285,1258,4354,"Olmsted County, Minnesota",27,109,27109
13475.0,603.0,147.0,18.0,7,5906,5666,1897,1105,1042,63,3769,2840,2499,341,5666,46605,0.4118,37.9,7134,13332,12319,62,45,1,91,814,"Wadena County, Minnesota",27,159,27159
39600.0,3250.0,619.0,84.0,256,20896,16452,3641,2159,2096,63,12811,9715,8268,1447,16452,57715,0.4091,39.4,17093,39604,36810,700,706,8,149,1231,"Benton County, Minnesota",27,009,27009
30243.0,857.0,336.0,112.0,85,14808,13009,4510,2766,2606,160,8499,6514,5873,641,13009,53631,0.4141,39.0,14357,30015,27297,451,680,27,359,1201,"Freeborn County, Minnesota",27,047,27047
44717.0,1625.0,380.0,33.0,152,19585,19506,7263,4303,4070,233,12243,9654,8673,981,19506,55139,0.4308,38.0,27667,44359,41554,280,156,17,11,2341,"Itasca County, Minnesota",27,061,27061
10904.0,614.0,74.0,10.0,7,5586,4981,1783,1040,998,42,3198,2470,2228,242,4981,61275,0.4163,40.9,6613,10872,10366,39,71,9,10,377,"Pope County, Minnesota",27,121,27121
9675.0,581.0,329.0,120.0,93,5263,3624,1088,638,620,18,2536,1886,1522,364,3624,60559,0.4854,37.8,4214,9696,8885,200,400,3,7,201,"Stevens County, Minnesota",27,149,27149
9234.0,533.0,47.0,52.0,15,4704,4263,1457,744,723,21,2806,2082,1953,129,4263,51620,0.4587,39.4,4843,9234,8712,29,104,20,95,274,"Swift County, Minnesota",27,151,27151
11096.0,399.0,276.0,71.0,31,5199,4846,1793,958,940,18,3053,2315,2187,128,4846,52087,0.3933,39.0,5423,11127,9980,202,351,0,174,420,"Cottonwood County, Minnesota",27,033,27033
143635.0,7362.0,1658.0,613.0,1562,79739,49479,10294,6796,6551,245,39185,33619,31446,2173,49479,102152,0.4009,38.8,51213,143534,126234,8210,3763,578,1205,3544,"Scott County, Minnesota",27,139,27139
21300.0,771.0,370.0,60.0,230,11075,9020,3042,1885,1775,110,5978,4779,4290,489,9020,65226,0.4161,40.4,10241,21362,20029,175,45,5,155,953,"Wabasha County, Minnesota",27,157,27157
9075.0,266.0,384.0,50.0,0,4170,3973,1272,646,633,13,2701,2013,1814,199,3973,52917,0.4643,40.2,4500,9032,8054,68,308,0,126,476,"Pipestone County, Minnesota",27,117,27117
6446.0,115.0,263.0,16.0,21,3117,2746,933,556,535,21,1813,1319,1174,145,2746,55085,0.4411,40.3,3429,6384,5913,19,67,0,42,343,"Norman County, Minnesota",27,107,27107
33595.0,2695.0,446.0,60.0,68,18670,12885,3622,2122,1990,132,9263,7243,6611,632,12885,67399,0.4215,35.8,13535,33722,31489,618,507,0,382,726,"Nicollet County, Minnesota",27,103,27103
757344.0,32650.0,12062.0,11047.0,5656,360412,237883,55396,43147,42109,1038,182487,159292,153620,5672,237883,97743,0.4343,39.6,251641,760164,491607,108397,71507,11885,29364,47404,"Fort Bend County, Texas",48,157,48157
1620.0,254.0,0.0,0.0,7,680,682,191,115,115,0,491,344,330,14,682,47500,0.4465,46.5,909,1604,1320,41,7,7,0,229,"Irion County, Texas",48,235,48235
21351.0,1116.0,80.0,111.0,0,7622,5782,2014,1533,1483,50,3768,3210,3041,169,5782,35521,0.465,39.3,7323,20335,13142,858,729,475,842,4289,"Willacy County, Texas",48,489,48489
12755.0,1135.0,107.0,70.0,0,4299,4322,1374,854,790,64,2948,2255,2099,156,4322,43239,0.4971,41.0,5187,11065,8822,277,127,38,161,1640,"Dawson County, Texas",48,115,48115
17830.0,850.0,168.0,125.0,25,7561,6810,2440,1651,1624,27,4370,3379,3128,251,6810,57731,0.4377,41.2,9203,17888,14647,269,253,92,566,2061,"Burleson County, Texas",48,051,48051
356775.0,13366.0,6972.0,1067.0,1954,163959,129451,36042,24115,22991,1124,93409,71659,64552,7107,129451,55919,0.459,40.4,149287,356637,275469,9906,10428,1792,9597,49445,"Nueces County, Texas",48,355,48355
11682.0,558.0,55.0,54.0,0,4897,4330,1841,1186,1125,61,2489,2023,1937,86,4330,51579,0.456,40.3,5398,11703,9098,127,204,70,105,2099,"Rains County, Texas",48,379,48379
3333.0,256.0,30.0,0.0,0,1069,1126,621,400,392,8,505,308,283,25,1126,35862,0.4533,39.4,2613,3308,2416,13,0,3,100,776,"Real County, Texas",48,385,48385
1224.0,35.0,0.0,0.0,0,623,458,94,57,52,5,364,310,305,5,458,59868,0.339,46.5,592,1194,856,21,43,0,13,261,"Sterling County, Texas",48,431,48431
5917.0,508.0,197.0,0.0,0,2891,2288,763,462,450,12,1525,1194,1152,42,2288,74872,0.4019,43.5,2796,5972,5284,53,44,0,15,576,"Carson County, Texas",48,065,48065
19459.0,1511.0,73.0,18.0,4,6911,6758,2520,1449,1414,35,4238,3430,3263,167,6758,49471,0.4663,42.6,9495,18047,14910,363,221,140,507,1906,"Freestone County, Texas",48,161,48161
3886.0,305.0,22.0,19.0,0,1695,1596,642,386,341,45,954,769,713,56,1596,41859,0.4485,42.1,2344,3935,3294,22,74,6,187,352,"Hardeman County, Texas",48,197,48197
1453.0,97.0,42.0,0.0,0,586,602,254,148,136,12,348,268,238,30,602,40227,0.4273,40.5,997,1457,1064,21,35,0,32,305,"Briscoe County, Texas",48,045,48045
82732.0,9595.0,850.0,62.0,98,30270,26873,7964,5119,4963,156,18909,15044,14351,693,26873,51494,0.4434,42.2,31362,76291,57691,1715,1783,336,2757,12009,"Liberty County, Texas",48,291,48291
90.0,0.0,0.0,0.0,0,33,30,15,9,7,2,15,13,13,0,30,83750,0.4906,,66,98,74,0,12,0,0,12,"Loving County, Texas",48,301,48301
16816.0,1048.0,139.0,62.0,4,7229,6444,2206,1497,1447,50,4238,3345,3126,219,6444,52928,0.4467,38.2,8855,16796,13765,287,516,179,207,1842,"Robertson County, Texas",48,395,48395
53020.0,6650.0,437.0,82.0,52,20872,18108,6108,4056,3907,149,12000,9835,9163,672,18108,55234,0.4529,41.8,21715,48945,38428,578,946,391,1715,6887,"Rusk County, Texas",48,401,48401
14468.0,930.0,123.0,6.0,41,4993,6030,2631,1769,1707,62,3399,2567,2411,156,6030,41357,0.4689,42.2,9011,14466,11350,64,179,79,231,2563,"Trinity County, Texas",48,455,48455
22064.0,2098.0,133.0,31.0,6,9092,8399,3924,2779,2746,33,4475,3428,3106,322,8399,58661,0.421,38.4,11930,22036,17664,288,275,71,409,3329,"Bandera County, Texas",48,019,48019
7181.0,486.0,74.0,0.0,0,2820,2407,723,348,344,4,1684,1272,1203,69,2407,43181,0.4419,41.6,2910,5747,4419,119,168,104,252,685,"Childress County, Texas",48,075,48075
140039.0,9828.0,3045.0,473.0,157,65484,51367,16506,11762,11443,319,34861,28409,26787,1622,51367,79936,0.4381,40.2,58181,140424,118568,3123,2612,580,2451,13090,"Comal County, Texas",48,091,48091
22695.0,1042.0,79.0,42.0,0,8166,8252,3384,2086,2023,63,4868,3643,3396,247,8252,37904,0.4579,41.2,11764,19877,16595,155,164,45,241,2677,"Houston County, Texas",48,225,48225
48098.0,2253.0,497.0,223.0,76,20410,17338,5515,3775,3554,221,11823,9384,8793,591,17338,48529,0.4553,40.2,20938,48192,35763,1635,1903,420,2331,6140,"Navarro County, Texas",48,349,48349
16817.0,934.0,103.0,33.0,0,6793,5941,1796,1012,1012,0,4145,3202,2992,210,5941,54326,0.4133,40.7,7217,15590,12045,193,402,294,147,2509,"Scurry County, Texas",48,415,48415
1455.0,77.0,4.0,19.0,0,620,580,204,101,101,0,376,273,273,0,580,51250,0.4414,43.5,930,1427,1200,11,16,0,0,200,"Stonewall County, Texas",48,433,48433
83196.0,5492.0,1559.0,293.0,43,35462,25571,7751,5290,4977,313,17820,14428,13629,799,25571,64597,0.432,39.7,30035,82357,63653,2019,3235,803,3842,8805,"Bastrop County, Texas",48,021,48021
32314.0,2899.0,171.0,47.0,0,9851,8269,2533,1591,1544,47,5736,4584,4208,376,8269,44578,0.4868,38.6,10739,24977,19727,340,120,64,134,4592,"Bee County, Texas",48,025,48025
4722.0,110.0,0.0,28.0,40,2100,1421,371,249,236,13,1050,914,898,16,1421,65969,0.4048,41.7,1681,4706,3412,309,276,34,133,542,"Crane County, Texas",48,103,48103
58451.0,627.0,1471.0,91.0,264,29280,25338,8880,5105,4744,361,16458,11526,9993,1533,25338,56139,0.4368,38.7,34411,58308,54156,933,519,76,26,2598,"Rutland County, Vermont",50,021,50021
28645.0,781.0,804.0,107.0,78,15089,12279,4243,2606,2419,187,8036,6037,5257,780,12279,60925,0.4005,39.0,15417,28823,26885,380,188,2,26,1342,"Orange County, Vermont",50,017,50017
54755.0,1039.0,1978.0,193.0,252,27192,24298,8912,5332,4971,361,15386,11100,9642,1458,24298,60987,0.4571,38.4,34882,54560,50062,1014,881,9,114,2480,"Windsor County, Vermont",50,027,50027
594409.0,18302.0,25574.0,6679.0,6187,276471,165991,30971,23276,22828,448,135020,122985,112123,10862,165991,74665,0.4189,35.1,174162,602118,522009,15124,16560,1894,11304,35227,"Utah County, Utah",49,049,49049
19845.0,1010.0,367.0,13.0,30,7931,6868,1547,1114,1081,33,5321,4480,4246,234,6868,63224,0.3931,40.4,10282,19787,16727,235,151,57,188,2429,"Duchesne County, Utah",49,013,49013
35572.0,964.0,1073.0,66.0,54,14657,10569,2411,1549,1541,8,8158,6522,6114,408,10569,65264,0.431,38.8,13747,35706,29670,312,319,103,110,5192,"Uintah County, Utah",49,047,49047
340110.0,15077.0,8735.0,1939.0,3335,164394,104551,22541,16573,16323,250,82010,71757,68339,3418,104551,83310,0.3806,37.3,108847,342098,307653,7951,4339,745,2950,18460,"Davis County, Utah",49,011,49011
10074.0,313.0,223.0,0.0,15,3886,3665,1206,753,748,5,2459,2058,1988,70,3665,55554,0.3689,37.8,4598,10056,9177,30,72,38,110,629,"Emery County, Utah",49,015,49015
4978.0,177.0,117.0,17.0,0,2172,1760,726,525,520,5,1034,841,767,74,1760,54565,0.4209,37.4,3913,4794,3973,21,43,6,78,673,"Garfield County, Utah",49,017,49017
36400.0,1940.0,409.0,392.0,44,17696,14587,4922,3050,2970,80,9665,7870,7319,551,14587,73991,0.4278,39.6,15678,36181,33147,481,240,0,354,1959,"Isle of Wight County, Virginia",51,093,51093
8020.0,298.0,93.0,0.0,17,3403,3522,1262,635,607,28,2260,1619,1540,79,3522,40417,0.4326,38.8,3847,8033,7409,84,0,0,26,514,"Franklin city, Virginia",51,620,51620
7205.0,568.0,532.0,73.0,0,2258,2158,903,355,325,30,1255,738,544,194,2158,42632,0.4953,33.0,2447,7161,6494,162,157,0,18,330,"Lexington city, Virginia",51,678,51678
50780.0,1592.0,458.0,77.0,95,19549,21218,8449,5059,4865,194,12769,8935,8079,856,21218,37952,0.4514,39.0,26196,50684,44782,426,425,271,259,4521,"Henry County, Virginia",51,089,51089
16538.0,532.0,110.0,35.0,15,8211,6078,1746,1244,1198,46,4332,3572,3516,56,6078,66987,0.3759,39.5,6983,16632,15591,219,96,20,0,706,"King William County, Virginia",51,101,51101
35631.0,1765.0,386.0,43.0,43,16310,13871,4934,3384,3153,231,8937,7200,6533,667,13871,60975,0.4702,40.0,17438,35946,31177,604,346,85,261,3473,"Louisa County, Virginia",51,109,51109
22730.0,1830.0,460.0,40.0,22,8440,7185,2690,1541,1507,34,4495,3388,2850,538,7185,47202,0.4566,34.3,9435,21536,19686,204,119,15,65,1447,"Prince Edward County, Virginia",51,147,51147
79396.0,3998.0,965.0,273.0,86,38557,30994,10697,7111,6806,305,20297,16505,15253,1252,30994,61864,0.4297,38.5,35504,79919,68520,1771,1366,264,1250,6748,"Rockingham County, Virginia",51,165,51165
38507.0,1716.0,1695.0,358.0,31,17998,14996,4399,2536,2451,85,10597,7577,6489,1088,14996,42273,0.474,35.5,18820,38465,35215,499,656,25,334,1736,"Calloway County, Kentucky",21,035,21035
15751.0,627.0,335.0,28.0,18,5593,6099,2168,1463,1353,110,3931,2769,2566,203,6099,34819,0.4503,39.0,7515,15511,13514,14,55,11,80,1837,"Casey County, Kentucky",21,045,21045
70349.0,1568.0,7678.0,1050.0,159,30898,25721,6124,3572,3418,154,19597,15114,13945,1169,25721,43919,0.4601,44.4,29912,61799,55018,836,557,71,229,5088,"Christian County, Kentucky",21,047,21047
99079.0,2567.0,2243.0,444.0,223,45180,40179,11786,6937,6563,374,28393,22019,20180,1839,40179,51673,0.4697,39.4,43122,98521,91508,913,1375,126,617,3982,"Daviess County, Kentucky",21,059,21059
25808.0,802.0,269.0,60.0,27,10528,9758,3142,1884,1851,33,6616,5238,4950,288,9758,38612,0.4537,39.5,13667,25935,24370,126,131,14,36,1258,"Grayson County, Kentucky",21,085,21085
45297.0,1139.0,816.0,125.0,63,19970,18643,5565,3259,3126,133,13078,9965,9166,799,18643,48926,0.4522,38.9,20560,44707,42114,317,167,36,160,1913,"Henderson County, Kentucky",21,101,21101
15802.0,1057.0,106.0,2.0,6,7193,6044,1938,1315,1255,60,4106,3285,3004,281,6044,53926,0.4249,39.1,6769,15830,14323,140,5,0,137,1225,"Henry County, Kentucky",21,103,21103
44780.0,1513.0,268.0,37.0,58,18548,18588,5580,3435,3302,133,13008,9830,9096,734,18588,47170,0.4489,39.9,21405,44314,40931,253,168,51,59,2852,"Hopkins County, Kentucky",21,107,21107
13126.0,316.0,160.0,0.0,51,4226,5484,1718,910,867,43,3766,3122,2992,130,5484,32138,0.4647,39.5,6613,13263,12651,0,0,0,0,612,"Jackson County, Kentucky",21,109,21109
59780.0,1954.0,704.0,87.0,14,23617,22573,6848,4167,4054,113,15725,12352,11696,656,22573,41526,0.4832,40.0,25867,59570,55313,324,78,33,50,3772,"Laurel County, Kentucky",21,125,21125
30995.0,948.0,593.0,14.0,30,13075,13121,4637,3027,2933,94,8484,6388,6047,341,13121,55113,0.4443,39.4,16175,30603,29022,129,52,76,43,1281,"Marshall County, Kentucky",21,157,21157
27904.0,1312.0,1742.0,149.0,47,12629,10685,2710,1769,1648,121,7975,6531,6026,505,10685,56603,0.4064,39.9,12442,27131,25600,203,142,23,30,1133,"Meade County, Kentucky",21,163,21163
27603.0,1728.0,441.0,0.0,0,11512,10481,3010,1960,1825,135,7471,6172,5618,554,10481,45516,0.4132,39.6,12007,27526,25433,77,106,13,98,1799,"Montgomery County, Kentucky",21,173,21173
7044.0,287.0,169.0,6.0,14,2743,2804,841,492,467,25,1963,1577,1472,105,2804,38149,0.4718,38.5,3293,7057,6393,30,0,0,30,604,"Nicholas County, Kentucky",21,181,21181
65250.0,3816.0,1240.0,256.0,77,31150,20911,5303,3848,3778,70,15608,13715,13417,298,20911,99128,0.4385,39.2,21973,62296,58368,1144,616,147,433,1588,"Oldham County, Kentucky",21,185,21185
37065.0,1614.0,447.0,58.0,89,19113,16663,5683,3457,3328,129,10980,8350,7530,820,16663,63819,0.446,39.4,21152,37080,35460,320,173,7,6,1114,"Douglas County, Minnesota",27,041,27041
5873.0,267.0,79.0,8.0,2,2883,2612,917,570,553,17,1695,1263,1181,82,2612,55466,0.4572,40.1,3302,5894,5545,17,36,3,0,293,"Grant County, Minnesota",27,051,27051
4260.0,126.0,103.0,13.0,11,2198,1860,610,336,323,13,1250,925,850,75,1860,59643,0.3943,40.6,2610,4157,3820,47,27,9,10,244,"Kittson County, Minnesota",27,069,27069
27835.0,1347.0,443.0,105.0,62,14815,10939,3248,2125,2051,74,7691,6222,5693,529,10939,71080,0.3919,40.0,12722,28106,26121,214,196,10,321,1244,"Le Sueur County, Minnesota",27,079,27079
10664.0,1005.0,44.0,21.0,8,4423,3995,1371,851,814,37,2624,2045,1892,153,3995,48801,0.4906,39.7,5726,10695,10025,1,4,0,0,665,"Owen County, Kentucky",21,187,21187
16663.0,707.0,126.0,12.0,22,6056,6544,1949,1202,1155,47,4595,3569,3459,110,6544,35720,0.4805,39.1,7861,16522,15749,8,3,0,2,760,"Rockcastle County, Kentucky",21,203,21203
54163.0,2924.0,1112.0,116.0,96,27950,20551,4781,3141,3034,107,15770,13210,12039,1171,20551,70817,0.4126,39.7,22007,54373,50054,528,566,0,882,2343,"Scott County, Kentucky",21,209,21209
127103.0,8532.0,4830.0,673.0,79,61939,48224,11321,7218,6859,359,36903,27797,23738,4059,48224,52270,0.4824,37.6,52886,127343,110768,3775,5815,205,1972,4808,"Warren County, Kentucky",21,227,21227
20746.0,713.0,364.0,46.0,48,8530,7605,2370,1689,1596,93,5235,4074,3926,148,7605,44036,0.4468,39.2,9482,20732,19014,182,95,0,111,1330,"Allen County, Kentucky",21,003,21003
19771.0,1322.0,241.0,17.0,20,9127,8106,2630,1795,1764,31,5476,4186,3681,505,8106,49637,0.4524,39.9,9064,19821,18211,209,248,13,563,577,"Bourbon County, Kentucky",21,017,21017
79384.0,3472.0,558.0,105.0,39,39577,29690,8392,5619,5409,210,21298,17361,16334,1027,29690,63348,0.3926,39.3,31463,79729,75522,706,490,0,126,2885,"Bullitt County, Kentucky",21,029,21029
8945.0,247.0,33.0,0.0,26,3606,3567,1245,837,816,21,2322,1690,1578,112,3567,45244,0.4396,40.9,4575,8769,7909,57,10,0,0,793,"Crittenden County, Kentucky",21,055,21055
6058.0,422.0,145.0,0.0,15,1976,2441,874,448,441,7,1567,1057,984,73,2441,30114,0.4688,36.2,3338,5680,5355,3,19,6,9,288,"Fulton County, Kentucky",21,075,21075
15102.0,660.0,311.0,17.0,32,4514,6388,1980,1227,1180,47,4408,3374,3130,244,6388,31198,0.469,38.2,7633,15123,14137,20,41,24,11,890,"Knott County, Kentucky",21,119,21119
6348.0,288.0,14.0,9.0,0,2355,2651,924,499,472,27,1727,1306,1237,69,2651,39325,0.4048,39.5,3943,6373,6133,18,0,0,20,202,"Menifee County, Kentucky",21,165,21165
30486.0,856.0,183.0,10.0,12,11521,11351,3814,2499,2435,64,7537,6006,5612,394,11351,43590,0.4383,38.7,13798,30296,28339,122,78,80,236,1441,"Muhlenberg County, Kentucky",21,177,21177
26375.0,626.0,591.0,165.0,12,8626,11226,3392,2105,2038,67,7834,6090,5677,413,11226,33640,0.5209,39.7,13000,26025,24562,65,39,0,227,1132,"Perry County, Kentucky",21,193,21193
7135.0,454.0,171.0,0.0,0,1770,2898,1029,639,582,57,1869,1272,1220,52,2898,24623,0.468,36.1,3726,7045,6867,9,5,0,0,164,"Wolfe County, Kentucky",21,237,21237
20066.0,536.0,264.0,25.0,8,5385,7622,2357,1614,1582,32,5265,4066,3929,137,7622,26840,0.4814,39.0,9026,19033,17635,26,29,0,105,1238,"Clay County, Kentucky",21,051,21051
26463.0,1165.0,373.0,8.0,20,7364,10624,3743,2247,2159,88,6881,5068,4800,268,10624,26272,0.4862,37.8,13235,26033,24584,51,19,0,48,1331,"Bell County, Kentucky",21,013,21013
6609.0,196.0,142.0,0.0,7,2494,2616,968,561,532,29,1648,1179,1115,64,2616,35344,0.4616,37.2,3662,6613,5894,20,41,0,14,644,"Cumberland County, Kentucky",21,057,21057
36836.0,936.0,366.0,171.0,46,15422,14316,4744,2632,2523,109,9572,6937,6451,486,14316,44043,0.4863,37.3,16886,36863,34071,412,284,0,352,1744,"Graves County, Kentucky",21,083,21083
6815.0,461.0,38.0,0.0,0,1978,2839,917,525,487,38,1922,1178,1082,96,2839,25275,0.5105,38.5,3477,6453,6220,0,56,0,0,177,"Lee County, Kentucky",21,129,21129
12669.0,861.0,48.0,0.0,28,5041,4958,1584,989,969,20,3374,2809,2662,147,4958,41763,0.4497,40.0,5954,12548,11553,33,16,0,203,743,"Butler County, Kentucky",21,031,21031
11993.0,664.0,442.0,15.0,0,4442,4885,1693,1113,1076,37,3192,2477,2301,176,4885,43401,0.424,39.4,6570,12046,11270,10,10,0,6,750,"Edmonson County, Kentucky",21,061,21061
18512.0,800.0,290.0,8.0,7,7963,7283,2353,1446,1380,66,4930,3996,3778,218,7283,48438,0.4465,39.9,8302,18520,17246,46,70,0,47,1111,"Harrison County, Kentucky",21,097,21097
8214.0,226.0,77.0,9.0,5,3629,3318,1043,573,551,22,2275,1767,1590,177,3318,49158,0.4398,38.7,3885,8274,7832,14,17,0,0,411,"Bracken County, Kentucky",21,023,21023
45142.0,2130.0,175.0,26.0,0,21133,17853,4955,3178,2892,286,12898,10222,9351,871,17853,60127,0.4693,40.3,19051,45283,42877,193,197,0,84,1932,"Nelson County, Kentucky",21,179,21179
20226.0,328.0,165.0,8.0,87,7330,8231,3066,1586,1567,19,5165,3991,3711,280,8231,34914,0.5368,40.3,10958,20229,17819,99,233,0,110,1968,"Wayne County, Kentucky",21,231,21231
19144.0,1163.0,72.0,8.0,34,7420,7405,2237,1248,1174,74,5168,3661,3268,393,7405,40107,0.4515,39.2,8308,18437,17335,85,159,0,0,858,"Marion County, Kentucky",21,155,21155
14283.0,577.0,449.0,5.0,0,5690,5892,2315,1458,1392,66,3577,2777,2533,244,5892,50536,0.4519,40.5,7945,14345,13006,119,67,0,0,1153,"Trigg County, Kentucky",21,221,21221
129588.0,6409.0,3774.0,710.0,483,66325,46997,11738,8033,7784,249,35259,28962,26936,2026,46997,78327,0.4166,39.3,49443,129906,118666,2710,2911,185,1532,3902,"Boone County, Kentucky",21,015,21015
52474.0,2564.0,1350.0,194.0,34,23833,18821,5321,3657,3537,120,13500,11122,10189,933,18821,58245,0.4954,38.1,20447,52513,47567,1178,706,36,739,2287,"Jessamine County, Kentucky",21,113,21113
31179.0,846.0,352.0,4.0,0,9607,11961,3825,2193,2106,87,8136,6121,5771,350,11961,30181,0.5238,39.0,14740,31003,29163,189,34,22,228,1367,"Knox County, Kentucky",21,121,21121
22037.0,245.0,69.0,56.0,63,6941,9721,3216,1863,1776,87,6505,4980,4722,258,9721,29886,0.5207,38.1,11758,22101,20992,17,28,13,39,1012,"Letcher County, Kentucky",21,133,21133
9205.0,336.0,128.0,0.0,0,3815,3857,1404,813,773,40,2453,1926,1738,188,3857,50839,0.4749,39.6,4872,9177,8781,32,0,0,0,364,"Livingston County, Kentucky",21,139,21139
59027.0,1364.0,1415.0,128.0,101,19637,25702,8010,4905,4770,135,17692,13609,12813,796,25702,34856,0.509,39.8,30934,58767,54812,237,137,11,61,3509,"Pike County, Kentucky",21,195,21195
46888.0,2285.0,926.0,218.0,96,23056,16624,5005,3193,3095,98,11619,9655,8934,721,16624,67056,0.4546,39.1,17823,46154,41076,634,888,63,1155,2338,"Shelby County, Kentucky",21,211,21211
22146.0,1834.0,53.0,25.0,4,10407,8694,2461,1409,1357,52,6233,5040,4577,463,8694,55334,0.4075,39.4,9410,22306,21310,66,159,0,23,748,"Anderson County, Kentucky",21,005,21005
19937.0,754.0,334.0,30.0,80,7420,7598,2636,1734,1596,138,4962,3923,3562,361,7598,47190,0.4372,39.9,10829,19912,18393,74,41,0,47,1357,"Breckinridge County, Kentucky",21,027,21027
50062.0,2685.0,1073.0,490.0,127,24162,21076,6169,3632,3473,159,14907,10215,9175,1040,21076,56274,0.4104,38.5,23252,49703,44290,577,653,59,796,3328,"Franklin County, Kentucky",21,073,21073
17274.0,376.0,604.0,42.0,0,4709,6052,1800,1197,1156,41,4252,3367,3131,236,6052,28105,0.4873,37.4,7523,16032,15271,23,6,0,56,676,"McCreary County, Kentucky",21,147,21147
89755.0,6252.0,2281.0,254.0,75,41405,33359,8548,5163,4993,170,24811,18741,16189,2552,33359,50060,0.4676,37.3,36707,89947,83417,933,1106,74,514,3903,"Madison County, Kentucky",21,151,21151
9907.0,284.0,191.0,15.0,0,3832,4074,1342,792,745,47,2732,2281,2179,102,4074,37386,0.4406,39.8,4736,9945,9272,47,35,0,0,591,"Metcalfe County, Kentucky",21,169,21169
4390.0,227.0,6.0,0.0,0,1257,1704,556,360,354,6,1148,853,805,48,1704,30284,0.5092,38.2,2230,4359,4196,12,0,0,0,151,"Owsley County, Kentucky",21,189,21189
17970.0,649.0,290.0,0.0,22,7859,7028,2070,1480,1350,130,4958,3732,3619,113,7028,48623,0.4271,40.0,7797,17828,16672,100,92,0,28,936,"Simpson County, Kentucky",21,213,21213
35601.0,1886.0,863.0,50.0,27,16090,14509,4622,2829,2681,148,9887,8049,7262,787,14509,54953,0.4544,39.8,15900,35598,33686,207,146,0,216,1343,"Clark County, Kentucky",21,049,21049
12122.0,399.0,186.0,68.0,0,4624,4644,1330,841,817,24,3314,2705,2531,174,4644,44005,0.4911,41.0,5341,12105,10093,63,104,0,136,1709,"Todd County, Kentucky",21,219,21219
10461.0,296.0,107.0,0.0,1,4447,4101,1102,596,579,17,2999,2241,1995,246,4101,43524,0.4884,39.8,4715,10391,9378,35,16,31,187,744,"Carroll County, Kentucky",21,041,21041
10107.0,162.0,172.0,0.0,1,3548,3985,1373,697,688,9,2612,1888,1808,80,3985,32184,0.5177,37.6,5320,10037,9126,44,0,0,71,796,"Clinton County, Kentucky",21,053,21053
8610.0,485.0,218.0,6.0,2,3807,3105,897,563,545,18,2208,1662,1489,173,3105,52167,0.3889,38.8,3920,8636,7830,8,47,24,127,600,"Gallatin County, Kentucky",21,077,21077
20143.0,626.0,268.0,0.0,34,7588,7459,2460,1525,1464,61,4999,3690,3508,182,7459,34029,0.4903,39.9,8994,19500,16894,12,19,72,2,2501,"Richland Parish, Louisiana",22,083,22083
5393.0,203.0,80.0,7.0,22,2092,1946,683,405,388,17,1263,950,875,75,1946,44688,0.442,39.7,2788,5473,4672,30,5,0,5,761,"Mahnomen County, Minnesota",27,087,27087
54841.0,3824.0,592.0,22.0,461,28702,20242,5655,3689,3432,257,14587,12370,11446,924,20242,83464,0.3569,38.5,21948,53902,51017,560,384,14,12,1915,"Chisago County, Minnesota",27,025,27025
15105.0,460.0,113.0,15.0,50,7455,6261,2090,1211,1185,26,4171,3121,2899,222,6261,55404,0.4099,39.6,7327,15008,13728,169,127,27,37,920,"Redwood County, Minnesota",27,127,27127
9663.0,432.0,137.0,16.0,36,4881,4087,1303,790,763,27,2784,2197,2025,172,4087,59210,0.4057,40.1,4767,9648,9049,107,86,0,17,389,"Yellow Medicine County, Minnesota",27,173,27173
24274.0,1173.0,262.0,184.0,39,10889,9819,3463,2223,2110,113,6356,4924,4576,348,9819,53585,0.406,41.0,13238,24309,21556,200,407,18,249,1879,"Todd County, Minnesota",27,153,27153
45833.0,3107.0,865.0,73.0,412,20638,17372,4780,2994,2801,193,12592,9236,8104,1132,17372,49160,0.4506,37.5,21595,45872,41234,376,248,32,39,3943,"Beltrami County, Minnesota",27,007,27007
66018.0,5342.0,1847.0,513.0,710,36770,26091,5882,3573,3381,192,20209,15576,11643,3933,26091,57429,0.4349,36.0,28415,66088,60472,1060,2039,100,240,2177,"Blue Earth County, Minnesota",27,013,27013
18537.0,325.0,376.0,21.0,23,10056,8253,2742,1698,1636,62,5511,4160,3767,393,8253,60382,0.399,40.1,8764,18443,17506,65,37,0,24,811,"Houston County, Minnesota",27,055,27055
6670.0,165.0,110.0,49.0,5,3310,3090,1174,684,654,30,1916,1425,1287,138,3090,53071,0.4409,40.3,3672,6598,6293,74,69,3,33,126,"Lac qui Parle County, Minnesota",27,073,27073
3733.0,61.0,91.0,0.0,5,1920,1470,598,334,334,0,872,621,580,41,1470,49967,0.3858,38.3,3806,3724,3592,18,7,0,0,107,"Lake of the Woods County, Minnesota",27,077,27077
57472.0,1640.0,1102.0,67.0,336,28092,24687,9076,5505,5277,228,15611,12132,11159,973,24687,58682,0.4335,39.5,36193,57546,53512,724,565,73,148,2524,"Otter Tail County, Minnesota",27,111,27111
18593.0,1188.0,315.0,29.0,32,9170,7425,2252,1284,1209,75,5173,3924,3696,228,7425,56762,0.4386,38.6,7961,17796,16757,320,145,0,81,493,"Waseca County, Minnesota",27,161,27161
197792.0,7811.0,4259.0,371.0,2194,96580,85807,26576,14472,13599,873,59231,42133,34919,7214,85807,55646,0.4454,36.5,104654,196528,184900,2721,1943,26,184,6754,"St. Louis County, Minnesota",27,137,27137
346276.0,18208.0,3621.0,797.0,5987,188738,128198,32936,21392,20567,825,95262,77527,70635,6892,128198,82175,0.3908,38.1,132137,347788,306835,18250,9156,750,2475,10322,"Anoka County, Minnesota",27,003,27003
156738.0,10707.0,2832.0,1164.0,1256,84328,59479,15146,9552,9165,387,44333,33815,28998,4817,59479,62789,0.4312,37.8,64664,157308,141798,3802,5986,370,547,4805,"Stearns County, Minnesota",27,145,27145
416511.0,18550.0,6998.0,1985.0,7409,230157,161488,40165,24031,23043,988,121323,97867,88788,9079,161488,86036,0.4122,38.4,166598,419507,369034,21688,14034,1138,4105,9508,"Dakota County, Minnesota",27,037,27037
25387.0,1091.0,662.0,181.0,51,13241,10018,2646,1577,1542,35,7372,5623,5039,584,10018,57730,0.4417,39.1,11277,25465,22472,628,844,72,517,932,"Lyon County, Minnesota",27,083,27083
9249.0,302.0,100.0,16.0,8,4762,3971,1372,837,810,27,2599,1974,1852,122,3971,60118,0.3895,41.6,4826,9300,8803,70,45,21,17,344,"Marshall County, Minnesota",27,089,27089
14444.0,459.0,95.0,22.0,34,7154,6085,1965,1117,1097,20,4120,3111,2807,304,6085,59028,0.4259,40.6,7353,14349,13250,100,212,4,128,655,"Renville County, Minnesota",27,129,27129
253339.0,12796.0,3909.0,918.0,2981,134878,94431,25478,16149,15335,814,68953,56802,52674,4128,94431,96671,0.4198,38.0,98421,252944,228785,10809,5823,343,575,6609,"Washington County, Minnesota",27,163,27163
5350.0,147.0,115.0,31.0,19,2553,2691,1031,693,668,25,1660,1224,1057,167,2691,57432,0.4027,38.6,6126,5338,4769,74,144,6,36,309,"Cook County, Minnesota",27,031,27031
3869.0,98.0,33.0,6.0,0,1537,1490,572,288,283,5,918,689,651,38,1490,40000,0.4846,39.7,2286,3888,3066,4,8,0,20,790,"Knox County, Missouri",29,103,29103
11343.0,506.0,94.0,21.0,35,4994,5014,1531,857,832,25,3483,2641,2372,269,5014,46757,0.4116,39.5,6240,11156,10058,24,45,24,10,995,"Montgomery County, Missouri",29,139,29139
29076.0,975.0,443.0,20.0,0,12198,11530,3872,2269,2195,74,7658,5859,5385,474,11530,41062,0.4369,39.6,13748,28946,25650,36,18,0,54,3188,"Stoddard County, Missouri",29,207,29207
25391.0,1805.0,432.0,94.0,0,10744,9286,2964,1879,1846,33,6322,4805,4195,610,9286,44261,0.4513,39.7,10893,23845,21041,127,112,0,159,2406,"Audrain County, Missouri",29,007,29007
286518.0,14585.0,6315.0,1343.0,1422,136985,125201,33469,18747,18075,672,91732,66222,54668,11554,125201,46086,0.4692,38.1,133459,285833,248548,3761,2851,427,1624,28622,"Greene County, Missouri",29,077,29077
9296.0,558.0,239.0,3.0,2,3493,4139,1775,1023,899,124,2364,1769,1643,126,4139,38870,0.4196,39.1,5656,9085,7855,84,23,0,0,1123,"St. Clair County, Missouri",29,185,29185
4497.0,124.0,141.0,0.0,4,1843,1475,494,315,295,20,981,682,627,55,1475,42694,0.4412,38.0,2106,4513,3791,29,10,0,0,683,"Schuyler County, Missouri",29,197,29197
45097.0,1884.0,1500.0,27.0,78,18526,16031,7443,5320,5057,263,8588,6752,6217,535,16031,53478,0.4508,39.0,41830,44913,38367,350,312,0,221,5663,"Camden County, Missouri",29,029,29029
221376.0,9048.0,1837.0,279.0,222,109952,84444,22677,15236,14549,687,61767,51017,47066,3951,84444,65454,0.3916,38.7,90974,222265,200923,2389,1054,311,512,17076,"Jefferson County, Missouri",29,099,29099
17342.0,707.0,141.0,20.0,42,6618,7371,2341,1237,1203,34,5030,3933,3590,343,7371,38679,0.4366,39.9,8606,17226,14554,33,37,0,20,2582,"New Madrid County, Missouri",29,143,29143
10018.0,378.0,109.0,0.0,0,4900,4036,1484,946,901,45,2552,2147,2045,102,4036,55377,0.4127,38.9,5198,10174,9271,50,9,0,22,822,"Ralls County, Missouri",29,173,29173
11618.0,566.0,167.0,30.0,24,6104,4903,1616,779,760,19,3287,2488,2239,249,4903,52965,0.4489,39.2,5700,11520,10735,101,12,0,6,666,"Custer County, Montana",30,017,30017
1586.0,43.0,89.0,0.0,1,866,737,315,206,199,7,422,345,285,60,737,54427,0.4086,43.6,1003,1579,1454,0,17,0,0,108,"Powder River County, Montana",30,075,30075
11066.0,252.0,260.0,15.0,66,3808,3150,844,475,463,12,2306,1710,1518,192,3150,43194,0.4745,39.3,4134,10953,7781,56,84,11,10,3011,"Roosevelt County, Montana",30,085,30085
2329.0,47.0,15.0,0.0,0,1143,895,375,227,214,13,520,381,342,39,895,44875,0.5778,40.8,1129,2330,2116,13,0,0,0,201,"Liberty County, Montana",30,051,30051
11011.0,237.0,606.0,8.0,9,5975,4535,1262,667,642,25,3273,2260,2082,178,4535,67205,0.409,40.7,5248,11199,9972,82,47,0,110,988,"Richland County, Montana",30,083,30083
4849.0,339.0,64.0,14.0,0,2118,1867,579,365,321,44,1288,910,865,45,1867,50721,0.4724,40.0,2369,4224,3745,121,22,3,1,332,"Toole County, Montana",30,101,30101
1719.0,27.0,32.0,0.0,0,856,857,334,150,136,14,523,385,367,18,857,57440,0.4373,45.5,1134,1706,1590,34,7,7,0,68,"Daniels County, Montana",30,019,30019
1938.0,52.0,28.0,2.0,0,896,906,307,199,192,7,599,374,351,23,906,43661,0.4657,43.5,1349,1954,1791,2,2,0,0,159,"Judith Basin County, Montana",30,045,30045
8995.0,611.0,387.0,0.0,6,3596,3903,1429,716,708,8,2474,1575,1518,57,3903,41820,0.4451,37.8,5203,8538,7776,67,58,0,8,629,"Deer Lodge County, Montana",30,023,30023
1750.0,0.0,25.0,0.0,0,761,723,275,177,172,5,448,328,312,16,723,49701,0.4408,43.9,1064,1770,1639,12,0,0,10,109,"McCone County, Montana",30,055,30055
9025.0,179.0,208.0,0.0,14,3879,3166,994,652,644,8,2172,1744,1536,208,3166,57992,0.4245,39.9,4159,9075,7257,47,64,0,56,1651,"Rosebud County, Montana",30,087,30087
8980.0,504.0,342.0,14.0,8,4661,3930,1302,605,590,15,2628,1986,1749,237,3930,58596,0.4262,41.0,4449,8709,8246,73,33,0,41,316,"Dawson County, Montana",30,021,30021
5855.0,466.0,236.0,14.0,0,2539,2364,930,626,581,45,1434,975,912,63,2364,60594,0.4298,39.6,2736,5900,5415,20,39,0,0,426,"Broadwater County, Montana",30,007,30007
4059.0,56.0,162.0,0.0,9,1714,1710,639,364,347,17,1071,690,648,42,1710,46212,0.4364,41.6,2352,4036,3353,24,6,0,15,638,"Phillips County, Montana",30,071,30071
472.0,36.0,0.0,0.0,2,246,213,91,60,57,3,122,87,87,0,213,51094,0.3334,47.8,322,477,451,0,0,0,0,26,"Blaine County, Nebraska",31,009,31009
1816.0,59.0,146.0,3.0,0,888,830,297,178,169,9,533,398,383,15,830,47287,0.3795,43.0,1066,1817,1518,8,17,0,5,269,"Deuel County, Nebraska",31,049,31049
901.0,34.0,37.0,2.0,3,450,347,123,74,73,1,224,185,161,24,347,52708,0.362,42.0,438,927,803,13,32,0,0,79,"Logan County, Nebraska",31,113,31113
5027.0,182.0,37.0,5.0,2,2528,2244,828,462,454,8,1416,1048,970,78,2244,51821,0.4085,42.2,2753,4913,4637,17,16,0,4,239,"Thayer County, Nebraska",31,169,31169
31222.0,1443.0,469.0,83.0,88,15485,12712,3975,2135,2045,90,8737,6339,5747,592,12712,53023,0.4435,39.0,13906,31310,27697,642,638,41,609,1683,"Adams County, Nebraska",31,001,31001
5245.0,175.0,49.0,11.0,30,2835,2311,804,445,432,13,1507,1181,1063,118,2311,54979,0.4372,41.6,2644,5180,4816,37,6,0,11,310,"Boone County, Nebraska",31,011,31011
53035.0,1387.0,148.0,75.0,31,22143,19749,5842,3857,3645,212,13907,10956,10315,641,19749,48656,0.4713,40.7,23384,53530,47123,309,151,19,458,5470,"St. Martin Parish, Louisiana",22,099,22099
48919.0,1268.0,4115.0,785.0,11,21245,17696,4092,2513,2438,75,13604,10418,9937,481,17696,49141,0.4534,43.9,22202,44034,38512,1046,542,36,149,3749,"Vernon Parish, Louisiana",22,115,22115
14210.0,721.0,143.0,66.0,31,5122,5483,1906,1117,1054,63,3577,2710,2607,103,5483,38353,0.4908,42.5,7317,12485,11082,57,0,0,13,1333,"Winn Parish, Louisiana",22,127,22127
438523.0,14209.0,8932.0,1637.0,2946,213188,164346,43222,26196,25049,1147,121124,85042,72895,12147,164346,54948,0.5052,38.3,194236,440747,386099,8476,8793,957,6875,29547,"East Baton Rouge Parish, Louisiana",22,033,22033
23689.0,481.0,188.0,44.0,16,7867,9158,3302,2042,1953,89,5856,4355,4104,251,9158,40336,0.4771,40.9,15056,23626,20643,73,93,29,142,2646,"Sabine Parish, Louisiana",22,085,22085
25213.0,1189.0,540.0,41.0,9,8550,7925,2558,1643,1607,36,5367,4096,3959,137,7925,46446,0.4525,42.2,9952,21284,19300,121,45,0,31,1787,"Allen Parish, Louisiana",22,003,22003
11147.0,712.0,128.0,12.0,6,3363,3832,1142,656,629,27,2690,1921,1814,107,3832,30350,0.5173,39.9,5106,9443,8346,49,10,23,1,1014,"Madison Parish, Louisiana",22,065,22065
31109.0,1402.0,125.0,0.0,30,11975,11726,3629,1990,1853,137,8097,6483,6296,187,11726,42105,0.4987,41.9,13919,30941,28182,161,80,0,54,2464,"Jefferson Davis Parish, Louisiana",22,053,22053
21031.0,356.0,272.0,21.0,126,8995,7719,2518,1737,1730,7,5201,4217,4002,215,7719,51603,0.4592,40.1,8919,21097,19085,36,44,0,122,1810,"St. James Parish, Louisiana",22,093,22093
22151.0,772.0,673.0,95.0,14,7259,6989,2176,1341,1317,24,4813,3467,3334,133,6989,42505,0.4394,40.0,9338,19197,17502,22,45,0,0,1628,"Grant Parish, Louisiana",22,043,22043
15331.0,801.0,143.0,0.0,12,5922,3869,1283,703,692,11,2586,1904,1805,99,3869,59637,0.4549,39.1,5446,12095,11007,53,130,26,40,839,"West Feliciana Parish, Louisiana",22,125,22125
429416.0,11364.0,7016.0,2178.0,2347,207616,169452,51778,31530,30201,1329,117674,84967,76913,8054,169452,54032,0.4658,39.8,188511,431285,347730,19323,15102,2973,19029,27128,"Jefferson Parish, Louisiana",22,051,22051
21004.0,257.0,190.0,12.0,26,6361,8166,2818,1647,1614,33,5348,3627,3510,117,8166,30441,0.5495,39.3,11415,21033,18520,70,40,0,0,2403,"Monroe County, Alabama",01,099,01099
32808.0,1042.0,312.0,54.0,23,12273,12677,4191,2602,2582,20,8486,6687,6519,168,12677,44886,0.4409,39.3,15296,32793,29644,77,103,0,118,2851,"Lawrence County, Alabama",01,079,01079
159432.0,7349.0,8432.0,1200.0,534,73873,60237,13234,8537,8222,315,47003,33782,28867,4915,60237,51463,0.5026,37.2,68972,159913,139578,2812,5096,236,821,11370,"Lee County, Alabama",01,081,01081
29713.0,590.0,268.0,85.0,5,11679,11997,4289,2303,2232,71,7708,6024,5798,226,11997,35930,0.4587,39.5,14737,29400,26631,105,93,87,86,2398,"Marion County, Alabama",01,093,01093
19982.0,376.0,487.0,75.0,25,6821,7637,2727,1514,1473,41,4910,3785,3601,184,7637,39848,0.4907,38.9,9588,18561,16831,20,13,5,47,1645,"Pickens County, Alabama",01,107,01107
12677.0,463.0,106.0,8.0,33,4067,5202,1625,781,759,22,3577,2206,2005,201,5202,24320,0.5289,34.8,6872,12666,10950,13,115,8,75,1505,"Sumter County, Alabama",01,119,01119
651299.0,17031.0,13443.0,1830.0,2666,300213,261231,73850,44216,42375,1841,187381,133217,121427,11790,261231,53901,0.5009,39.4,307874,652887,575407,8239,9042,1035,8560,50604,"Jefferson County, Alabama",01,073,01073
12801.0,245.0,375.0,55.0,0,4075,5300,2058,1344,1261,83,3242,2229,2179,50,5300,35892,0.469,40.6,7359,12796,11391,46,36,0,0,1323,"Choctaw County, Alabama",01,023,01023
31062.0,668.0,267.0,106.0,11,12752,11048,3627,2128,2083,45,7421,5893,5586,307,11048,43514,0.4276,39.1,14052,31264,26067,494,1047,102,1174,2380,"Franklin County, Alabama",01,059,01059
19082.0,276.0,80.0,2.0,0,6578,7361,2303,1167,1096,71,5058,2824,2737,87,7361,33241,0.5495,39.5,10348,19098,17368,12,31,0,30,1657,"Marengo County, Alabama",01,091,01091
57142.0,1578.0,4605.0,149.0,0,24517,23262,5912,3472,3388,84,17350,12321,11560,761,23262,42443,0.4661,39.0,27680,56218,48491,734,546,153,646,5648,"Russell County, Alabama",01,113,01113
25646.0,804.0,424.0,11.0,21,9865,10737,4045,2611,2521,90,6692,5074,4786,288,10737,41919,0.4515,39.9,16579,25636,23248,142,29,0,51,2166,"Cherokee County, Alabama",01,019,01019
36672.0,933.0,536.0,62.0,5,14646,14852,5370,3205,3098,107,9482,7379,6826,553,14852,42189,0.4598,40.3,18976,36647,32270,161,149,0,0,4067,"Covington County, Alabama",01,039,01039
13711.0,210.0,44.0,0.0,44,5641,4943,1720,997,982,15,3223,2540,2402,138,4943,43163,0.4921,39.3,6815,13611,12234,68,124,0,0,1185,"Crenshaw County, Alabama",01,041,01041
38394.0,775.0,330.0,60.0,0,14029,15910,5196,2988,2869,119,10714,7811,7459,352,15910,33845,0.4691,40.3,20419,38879,34063,105,395,0,5,4311,"Dallas County, Alabama",01,047,01047
91700.0,4285.0,2629.0,393.0,0,39687,38471,12843,7471,7177,294,25628,19771,17554,2217,38471,48094,0.4601,38.3,45001,91654,82220,490,687,174,463,7620,"Lauderdale County, Alabama",01,077,01077
9973.0,193.0,71.0,10.0,13,3357,4251,1445,831,821,10,2806,2018,1920,98,4251,30036,0.5064,38.5,5224,9977,9093,10,0,0,66,808,"Lowndes County, Alabama",01,085,01085
18577.0,518.0,573.0,45.0,18,6935,7474,2732,1622,1528,94,4742,3097,2751,346,7474,33370,0.5095,35.1,10296,18449,16978,50,36,14,13,1358,"Macon County, Alabama",01,087,01087
93701.0,5599.0,2012.0,136.0,86,40176,32143,9529,5814,5664,150,22614,18010,17028,982,32143,59686,0.4454,38.9,36056,91733,80900,1305,710,197,1260,7361,"Limestone County, Alabama",01,083,01083
210928.0,10218.0,4961.0,525.0,47,105614,79630,21677,14107,13856,251,57953,45630,42810,2820,79630,77799,0.4392,39.6,86988,211801,190581,4255,3853,352,3465,9295,"Shelby County, Alabama",01,117,01117
23636.0,789.0,196.0,36.0,27,8860,9592,3445,2026,1976,50,6147,4617,4292,325,9592,35788,0.4752,38.8,13669,23451,20390,71,110,0,176,2704,"Winston County, Alabama",01,133,01133
210908.0,4947.0,6060.0,742.0,45,93141,80930,28759,18501,17779,722,52171,38474,35688,2786,80930,58320,0.4587,39.4,114164,210305,186016,3204,2406,422,1868,16389,"Baldwin County, Alabama",01,003,01003
80394.0,5715.0,1154.0,349.0,18,34080,29708,8457,5695,5563,132,21251,16616,15967,649,29708,60891,0.4413,40.8,34165,76190,69487,640,408,18,559,5078,"Elmore County, Alabama",01,051,01051
51091.0,419.0,637.0,23.0,9,19927,20695,6945,4346,4246,100,13750,10563,10210,353,20695,41769,0.4516,38.6,25041,51352,45992,330,147,58,175,4650,"Jackson County, Alabama",01,071,01071
79536.0,2783.0,1092.0,89.0,70,30439,31395,10031,6102,5773,329,21364,16073,15095,978,31395,41325,0.467,40.2,37861,77376,69436,315,397,41,342,6845,"Talladega County, Alabama",01,121,01121
16442.0,433.0,138.0,25.0,0,5484,5990,2213,1484,1410,74,3777,2902,2798,104,5990,41370,0.4989,41.1,8554,16418,14480,390,7,27,25,1489,"Washington County, Alabama",01,129,01129
13252.0,137.0,86.0,19.0,0,5457,5198,1773,1132,1132,0,3425,2720,2572,148,5198,40845,0.4615,37.8,6799,13091,11632,86,19,0,162,1192,"Clay County, Alabama",01,027,01027
117781.0,3646.0,1756.0,69.0,92,51201,45918,14210,8430,8239,191,31708,24742,22943,1799,45918,52156,0.4526,38.8,52050,117389,103016,1351,1734,167,2178,8943,"Morgan County, Alabama",01,103,01103
32964.0,1652.0,769.0,518.0,38,13900,11601,3287,1950,1894,56,8314,5317,4528,789,11601,37446,0.5367,36.9,16123,33132,28870,236,796,27,356,2847,"Pike County, Alabama",01,109,01109
54083.0,1488.0,412.0,180.0,25,22521,21880,7326,4569,4460,109,14554,11090,10337,753,21880,48065,0.4467,39.2,26588,54306,49567,379,444,30,210,3676,"Colbert County, Alabama",01,033,01033
48521.0,2082.0,3353.0,301.0,7,20189,18806,5761,3527,3439,88,13045,9934,9076,858,18806,47214,0.4479,39.8,23103,46283,39791,579,543,45,477,4848,"Dale County, Alabama",01,045,01045
14697.0,444.0,108.0,9.0,9,5229,5650,1979,1214,1194,20,3671,2567,2417,150,5650,34046,0.4994,38.6,7792,14582,13177,14,10,0,0,1381,"Hale County, Alabama",01,065,01065
70384.0,1971.0,1183.0,147.0,51,29311,26040,7992,4879,4785,94,18048,14235,13564,671,26040,40440,0.4723,39.3,31309,70519,58705,578,1595,242,2779,6620,"DeKalb County, Alabama",01,049,01049
36628.0,353.0,443.0,0.0,39,12649,13089,4630,2628,2599,29,8459,5911,5420,491,13089,36275,0.4818,39.2,16586,34190,29172,134,24,45,47,4768,"Escambia County, Alabama",01,053,01053
22452.0,764.0,286.0,0.0,9,8666,8702,3282,1997,1892,105,5420,3992,3828,164,8702,43395,0.4815,40.0,12097,22393,20119,171,70,0,47,1986,"Randolph County, Alabama",01,111,01111
408937.0,4260.0,7399.0,1047.0,767,172581,156251,46615,29118,28168,950,109636,78236,72263,5973,156251,47583,0.476,38.9,183671,408589,352990,6149,3513,1028,2191,42718,"Mobile County, Alabama",01,097,01097
9293.0,342.0,142.0,3.0,0,2565,3070,1267,542,542,0,1803,958,934,24,3070,23447,0.4938,35.8,4736,9135,8111,156,22,0,21,825,"Perry County, Alabama",01,105,01105
14833.0,554.0,670.0,27.0,2,5428,5680,2045,1188,1129,59,3635,2832,2677,155,5680,44741,0.457,40.0,6844,14736,12798,77,53,14,88,1706,"Cleburne County, Alabama",01,029,01029
12318.0,169.0,42.0,7.0,9,4194,4553,1814,1161,1132,29,2739,1888,1865,23,4553,37837,0.4296,39.6,7182,12349,10667,93,23,0,0,1566,"Conecuh County, Alabama",01,035,01035
25050.0,765.0,483.0,71.0,27,8231,9345,3356,2055,2050,5,5989,4307,4137,170,9345,32525,0.4883,38.8,12013,22475,19591,136,204,192,128,2224,"Barbour County, Alabama",01,005,01005
22141.0,1239.0,233.0,25.0,0,8167,6891,2284,1482,1471,11,4607,3446,3318,128,6891,47542,0.4487,40.0,9185,20632,18343,87,1,53,163,1985,"Bibb County, Alabama",01,007,01007
113053.0,3992.0,2517.0,130.0,185,47207,44605,13980,8900,8534,366,30625,23183,21426,1757,44605,47255,0.4633,39.7,53631,112854,99915,1262,940,236,588,9913,"Calhoun County, Alabama",01,015,01015
23923.0,215.0,282.0,31.0,0,7663,9090,3150,1976,1966,10,5940,3831,3696,135,9090,37404,0.5158,41.4,12784,23826,21465,43,13,0,1,2304,"Clarke County, Alabama",01,025,01025
16264.0,829.0,146.0,33.0,0,6275,6802,2449,1631,1594,37,4353,3360,3180,180,6802,39856,0.461,39.1,8505,16299,14922,120,21,4,9,1223,"Fayette County, Alabama",01,057,01057
1382.0,75.0,19.0,0.0,0,754,623,235,142,139,3,388,303,278,25,623,56250,0.4407,43.0,903,1374,1243,7,0,0,0,124,"Rock County, Nebraska",31,149,31149
2999.0,56.0,30.0,26.0,1,1439,1368,536,291,275,16,832,655,587,68,1368,50781,0.4203,42.7,1952,2977,2691,10,4,14,19,239,"Sherman County, Nebraska",31,163,31163
36631.0,1847.0,856.0,243.0,15,14329,13520,4007,2480,2369,111,9513,7343,6850,493,13520,53209,0.4441,42.2,15813,36328,32072,315,236,19,198,3488,"Beauregard Parish, Louisiana",22,011,22011
13472.0,330.0,96.0,39.0,6,4558,5812,2047,1080,1044,36,3765,2698,2542,156,5812,30272,0.5069,39.9,7894,13224,11859,27,23,25,16,1274,"Bienville Parish, Louisiana",22,013,22013
125045.0,3822.0,3669.0,774.0,244,58235,49377,11833,7633,7418,215,37544,28831,25921,2910,49377,54268,0.4529,40.8,56946,120404,106541,2280,1322,407,939,8915,"Bossier Parish, Louisiana",22,015,22015
6887.0,64.0,35.0,26.0,14,3140,2734,812,572,563,9,1922,1666,1547,119,2734,53423,0.4348,41.5,4125,6900,6186,47,0,53,193,421,"Cameron Parish, Louisiana",22,023,22023
19167.0,1451.0,165.0,11.0,10,6382,6959,2516,1633,1630,3,4443,3414,3147,267,6959,51803,0.4662,39.0,8487,15929,14508,48,47,4,9,1313,"East Feliciana Parish, Louisiana",22,037,22037
42853.0,1536.0,842.0,79.0,38,18843,15270,4276,2861,2690,171,10994,8910,8414,496,15270,57429,0.4469,40.7,17778,42582,37037,543,546,349,301,3806,"St. John the Baptist Parish, Louisiana",22,095,22095
23128.0,603.0,1101.0,71.0,19,10456,8919,2276,1426,1382,44,6643,5572,5337,235,8919,57204,0.4797,42.5,10174,22161,20003,626,114,0,408,1010,"Plaquemines Parish, Louisiana",22,075,22075
153319.0,3817.0,1789.0,401.0,708,62788,56556,15791,9221,8937,284,40765,29196,26651,2545,56556,41121,0.5229,38.9,68357,150889,134271,1235,839,225,627,13692,"Ouachita Parish, Louisiana",22,073,22073
45900.0,1369.0,906.0,42.0,36,17078,17613,6109,3842,3684,158,11504,8781,8240,541,17613,37570,0.4585,40.2,21777,44573,39074,188,54,16,240,5001,"Washington Parish, Louisiana",22,117,22117
82297.0,2101.0,314.0,109.0,61,30439,30485,9127,5239,5076,163,21358,16189,15243,946,30485,36403,0.5099,40.2,36925,82029,73458,209,173,42,311,7836,"St. Landry Parish, Louisiana",22,097,22097
61446.0,2031.0,301.0,108.0,32,24628,22236,6391,3796,3518,278,15845,12804,12001,803,22236,43396,0.4791,40.6,26435,61533,54733,193,63,134,425,5985,"Acadia Parish, Louisiana",22,001,22001
50181.0,2152.0,247.0,238.0,16,18902,19856,6086,3256,3145,111,13770,8887,8209,678,19856,40485,0.4689,40.5,23504,50188,44687,623,880,31,527,3440,"St. Mary Parish, Louisiana",22,101,22101
252408.0,7652.0,4699.0,325.0,183,115715,92962,29221,19142,18188,954,63741,50861,47190,3671,92962,68905,0.4638,39.2,102909,252612,225573,4459,2608,462,2843,16667,"St. Tammany Parish, Louisiana",22,103,22103
22074.0,608.0,197.0,13.0,42,8613,7582,3025,1755,1726,29,4557,3333,3173,160,7582,44100,0.4869,39.5,11837,21811,19434,73,183,0,143,1978,"Union Parish, Louisiana",22,111,22111
242512.0,4434.0,3247.0,738.0,1591,102126,95864,29018,16954,16174,780,66846,46780,42760,4020,95864,41797,0.5188,38.9,113247,241306,214771,2216,1920,208,1187,21004,"Caddo Parish, Louisiana",22,017,22017
121294.0,3164.0,2005.0,275.0,48,58552,43032,9788,6418,6128,290,33244,27195,25621,1574,43032,80527,0.4231,40.5,47391,122284,111957,1054,1108,171,1509,6485,"Ascension Parish, Louisiana",22,005,22005
238708.0,10148.0,3995.0,726.0,967,117614,91543,20866,12522,11942,580,70677,52521,45710,6811,91543,56999,0.4926,38.8,102491,239785,211619,2922,3183,344,3568,18149,"Lafayette Parish, Louisiana",22,055,22055
70823.0,2276.0,458.0,189.0,36,29765,26184,7275,4681,4569,112,18909,15030,13898,1132,26184,46861,0.4509,40.6,30595,71122,61824,787,601,282,1041,6587,"Iberia Parish, Louisiana",22,045,22045
46635.0,2457.0,1074.0,218.0,0,20784,17712,4624,2571,2498,73,13088,10026,7909,2117,17712,35467,0.5381,36.5,20251,46493,41115,551,830,0,565,3432,"Lincoln Parish, Louisiana",22,061,22061
10241.0,612.0,136.0,0.0,0,3760,3857,1374,788,769,19,2483,2038,1998,40,3857,43886,0.4986,41.0,5330,10133,8828,20,0,0,150,1135,"St. Helena Parish, Louisiana",22,091,22091
38703.0,1059.0,368.0,42.0,54,14446,16551,5490,3180,3020,160,11061,7950,7275,675,16551,28951,0.485,39.7,19681,38304,34433,234,52,42,97,3446,"Webster Parish, Louisiana",22,119,22119
27006.0,1178.0,153.0,60.0,119,10676,10821,3506,2235,2123,112,7315,5421,5131,290,10821,46006,0.5028,40.1,13055,27072,24343,128,38,8,47,2508,"De Soto Parish, Louisiana",22,031,22031
32635.0,2412.0,535.0,4.0,71,12537,10903,3357,2191,2111,80,7546,5607,5261,346,10903,50161,0.4652,40.0,13396,29585,26502,120,46,0,60,2857,"Iberville Parish, Louisiana",22,047,22047
136622.0,4268.0,872.0,283.0,79,62914,48410,12880,8483,8051,432,35530,29016,26992,2024,48410,63389,0.4271,39.9,56745,137892,124481,1144,438,128,1413,10288,"Livingston Parish, Louisiana",22,063,22063
25506.0,413.0,129.0,1.0,10,9138,9732,3210,1874,1834,40,6522,4743,4360,383,9732,32929,0.4848,38.1,12678,24843,22424,117,20,23,46,2213,"Morehouse Parish, Louisiana",22,067,22067
386193.0,10050.0,11571.0,2453.0,12119,178947,153819,39170,20491,19022,1469,114649,62710,53225,9485,153819,41604,0.5696,38.6,191808,384363,332025,9121,7710,940,3717,30850,"Orleans Parish, Louisiana",22,071,22071
110548.0,3630.0,1311.0,412.0,102,45903,39972,10952,6597,6334,263,29020,23261,20792,2469,39972,48747,0.4879,41.6,45424,110681,96427,1123,885,351,1553,10342,"Terrebonne Parish, Louisiana",22,109,22109
199399.0,4352.0,3903.0,371.0,374,88695,77780,21393,13138,12482,656,56387,42204,38148,4056,77780,51148,0.4757,39.5,90168,199425,177407,2000,1754,207,1433,16624,"Calcasieu Parish, Louisiana",22,019,22019
15848.0,560.0,225.0,28.0,0,5023,5917,2104,1254,1239,15,3813,2644,2479,165,5917,26776,0.5331,39.2,7877,13848,12263,20,72,0,10,1483,"Claiborne Parish, Louisiana",22,027,22027
40315.0,1539.0,146.0,184.0,22,14446,15163,4556,2723,2611,112,10607,7856,7229,627,15163,38565,0.5082,41.5,18534,36999,33654,133,128,5,79,3000,"Avoyelles Parish, Louisiana",22,009,22009
15804.0,1073.0,81.0,25.0,1,5403,5971,2261,1289,1266,23,3710,2890,2749,141,5971,39139,0.4754,40.8,7878,14616,13133,81,79,3,94,1226,"Jackson Parish, Louisiana",22,049,22049
21827.0,1017.0,29.0,103.0,61,8711,8960,3232,1793,1772,21,5728,4248,3853,395,8960,41480,0.5435,41.4,11589,21889,19659,141,26,0,111,1952,"Pointe Coupee Parish, Louisiana",22,077,22077
52340.0,1673.0,980.0,105.0,49,24238,19212,4708,3372,3231,141,14504,11959,11232,727,19212,69019,0.4358,40.4,20710,52080,47096,872,388,104,307,3313,"St. Charles Parish, Louisiana",22,089,22089
97057.0,2854.0,766.0,278.0,290,42261,36895,10258,6502,6119,383,26637,21178,19293,1885,36895,55506,0.4664,41.7,41117,97232,86711,777,981,186,927,7650,"Lafourche Parish, Louisiana",22,057,22057
4463.0,61.0,75.0,0.0,5,1276,1792,793,450,427,23,999,722,675,47,1792,27500,0.4801,40.7,3432,4542,3684,28,12,0,0,818,"Tensas Parish, Louisiana",22,107,22107
14678.0,483.0,119.0,11.0,7,5224,4814,1645,993,981,12,3169,2700,2662,38,4814,42104,0.4607,45.2,6711,13560,12160,24,9,0,0,1367,"LaSalle Parish, Louisiana",22,059,22059
33899.0,1072.0,761.0,132.0,30,16010,15336,6584,4012,3820,192,8752,6834,5973,861,15336,57720,0.4404,38.5,23978,33756,29537,587,257,18,62,3295,"Lincoln County, Maine",23,015,23015
39258.0,1499.0,1282.0,173.0,66,18359,17236,6257,4261,3939,322,10979,8312,7160,1152,17236,51931,0.4422,37.6,22455,39375,34277,418,296,39,99,4246,"Waldo County, Maine",23,027,23027
16715.0,707.0,263.0,18.0,2,6248,7025,2997,1836,1700,136,4028,3042,2704,338,7025,40890,0.4521,38.4,15463,16678,14678,108,189,7,19,1677,"Piscataquis County, Maine",23,021,23021
67157.0,769.0,1293.0,64.0,30,29128,29516,11001,6192,5848,344,18515,13575,12439,1136,29516,41123,0.4627,38.6,39916,66515,58132,1927,837,64,96,5459,"Aroostook County, Maine",23,003,23003
31249.0,657.0,836.0,76.0,34,12263,13791,5293,3109,2887,222,8498,6268,5641,627,13791,41347,0.467,37.8,23364,30890,26084,579,488,94,80,3565,"Washington County, Maine",23,029,23029
39401.0,1033.0,886.0,34.0,61,19364,17020,6858,3975,3813,162,10162,7617,6780,837,17020,57751,0.4364,37.5,24400,38387,33966,403,407,57,4,3550,"Knox County, Maine",23,013,23013
35135.0,1770.0,521.0,63.0,25,18302,15980,5470,3281,3140,141,10510,7763,6988,775,15980,63694,0.4125,38.8,18830,35356,31735,722,612,73,5,2209,"Sagadahoc County, Maine",23,023,23023
120408.0,4233.0,2229.0,278.0,72,58527,52105,16824,9740,8950,790,35281,26567,22918,3649,52105,55365,0.4396,38.5,62754,120100,108544,1428,1186,113,143,8686,"Kennebec County, Maine",23,011,23011
29765.0,1500.0,787.0,60.0,5,14250,11848,4251,2551,2342,209,7597,5555,4904,651,11848,51422,0.4339,37.9,22181,29835,26450,229,171,7,16,2962,"Franklin County, Maine",23,007,23007
54041.0,1583.0,1064.0,168.0,184,26573,23661,9106,5623,5051,572,14555,10992,9854,1138,23661,57178,0.4582,38.8,41260,54099,47021,754,796,18,95,5415,"Hancock County, Maine",23,009,23009
601758.0,20986.0,14838.0,3797.0,48244,275900,239116,63242,32249,29466,2783,175874,111595,90809,20786,239116,50379,0.5145,38.9,294296,600459,522155,18562,20206,1619,8867,29050,"Baltimore city, Maryland",24,510,24510
25585.0,2578.0,353.0,36.0,66,8635,8574,2883,1753,1645,108,5691,4135,3843,292,8574,37803,0.4665,35.9,11437,21611,19487,563,300,139,90,1032,"Somerset County, Maryland",24,039,24039
249062.0,6515.0,5184.0,953.0,1716,129751,93955,27784,18160,17565,595,66171,54116,50079,4037,93955,89147,0.4128,38.8,100210,249491,229424,8825,2752,480,1079,6931,"Harford County, Maryland",24,025,24025
70788.0,2690.0,1837.0,128.0,174,27857,27399,9608,5287,4973,314,17791,13366,11611,1755,27399,45893,0.439,37.3,32900,65844,61689,535,473,23,64,3060,"Allegany County, Maryland",24,001,24001
6349.0,185.0,86.0,4.0,12,3296,2720,963,543,519,24,1757,1427,1310,117,2720,59348,0.3701,43.0,3101,6417,5936,65,34,0,12,370,"Howard County, Nebraska",31,093,31093
2000.0,94.0,19.0,10.0,14,1122,942,327,234,231,3,615,425,375,50,942,64053,0.4242,41.7,1348,1977,1815,36,26,7,0,93,"Gosper County, Nebraska",31,073,31073
178834.0,7829.0,6901.0,1113.0,171,97242,66260,14315,9257,8902,355,51945,42549,39110,3439,66260,82032,0.3868,39.5,69059,176609,159897,4044,3078,547,1379,7664,"Sarpy County, Nebraska",31,153,31153
1930.0,23.0,26.0,2.0,1,979,904,404,232,232,0,500,371,347,24,904,47778,0.4572,41.8,1395,1909,1640,6,7,0,12,244,"Boyd County, Nebraska",31,015,31015
5484.0,292.0,31.0,0.0,2,2832,2510,823,449,427,22,1687,1186,1092,94,2510,60313,0.4542,42.4,2928,5318,4931,66,10,2,7,302,"Fillmore County, Nebraska",31,059,31059
693.0,16.0,48.0,0.0,0,277,318,143,100,94,6,175,92,88,4,318,41125,0.4108,45.8,455,667,608,2,0,0,0,57,"Hooker County, Nebraska",31,091,31091
16931.0,1132.0,429.0,13.0,0,8967,6600,1992,1181,1147,34,4608,3646,3311,335,6600,70389,0.3952,38.4,7159,16890,15796,111,123,17,0,843,"Seward County, Nebraska",31,159,31159
3483.0,224.0,106.0,0.0,1,1675,1507,502,274,266,8,1005,726,695,31,1507,46188,0.484,42.5,1905,3459,3207,28,2,0,0,222,"Webster County, Nebraska",31,181,31181
7942.0,316.0,43.0,23.0,7,4151,3363,1088,604,585,19,2275,1696,1586,110,3363,58979,0.3958,40.6,4075,7861,7317,89,39,11,30,375,"Butler County, Nebraska",31,023,31023
425.0,23.0,0.0,1.0,0,191,197,93,39,39,0,104,74,66,8,197,42813,0.4787,49.4,279,427,376,0,2,3,0,46,"Arthur County, Nebraska",31,005,31005
21343.0,836.0,234.0,41.0,11,10816,8979,2982,1604,1555,49,5997,4293,3912,381,8979,53110,0.4212,40.2,10449,21284,19833,162,166,10,27,1086,"Gage County, Nebraska",31,067,31067
6478.0,219.0,46.0,1.0,0,3331,2666,856,508,497,11,1810,1293,1204,89,2666,60266,0.4083,40.2,2967,6465,5822,40,206,12,0,385,"Kearney County, Nebraska",31,099,31099
34724.0,1825.0,741.0,55.0,135,17926,14205,3567,2037,1964,73,10638,7882,6975,907,14205,53188,0.4422,39.1,15306,34465,29571,645,1204,232,405,2408,"Madison County, Nebraska",31,119,31119
9010.0,356.0,147.0,16.0,0,4609,3905,1172,666,660,6,2733,2045,1790,255,3905,59040,0.4328,42.1,4262,8860,8443,19,55,8,41,294,"Phelps County, Nebraska",31,137,31137
9263.0,887.0,299.0,10.0,0,4981,3708,987,552,528,24,2721,2133,1726,407,3708,56456,0.443,35.8,3940,9301,8652,119,193,0,14,323,"Wayne County, Nebraska",31,179,31179
8348.0,273.0,164.0,125.0,5,4141,3586,1338,762,736,26,2248,1721,1611,110,3586,52332,0.4166,43.0,4946,8232,7516,49,23,0,18,626,"Knox County, Nebraska",31,107,31107
7665.0,461.0,47.0,6.0,13,3835,3373,1059,622,589,33,2314,1794,1658,136,3373,55649,0.4135,40.9,3821,7689,6849,43,95,0,72,630,"Merrick County, Nebraska",31,121,31121
2618.0,49.0,45.0,6.0,0,1196,1222,516,301,287,14,706,533,483,50,1222,46452,0.449,41.7,1627,2610,2228,16,21,0,0,345,"Pawnee County, Nebraska",31,133,31133
762.0,65.0,4.0,0.0,0,386,346,126,84,83,1,220,145,138,7,346,51591,0.3746,45.2,561,783,690,0,4,0,0,89,"Wheeler County, Nebraska",31,183,31183
5569.0,164.0,56.0,43.0,318,2572,2198,541,352,309,43,1657,1285,1259,26,2198,88030,0.3986,42.9,2657,5597,4717,248,259,12,78,283,"Lander County, Nevada",32,015,32015
963.0,57.0,22.0,0.0,0,382,491,205,108,93,15,286,130,109,21,491,37375,0.3744,40.1,950,963,825,12,11,8,38,69,"Esmeralda County, Nevada",32,009,32009
4446.0,90.0,118.0,1.0,0,1520,2048,1001,452,427,25,1047,631,586,45,2048,35806,0.4515,39.3,2916,4388,3853,74,29,7,0,425,"Mineral County, Nevada",32,021,32021
5144.0,485.0,146.0,31.0,0,1789,2018,928,445,423,22,1090,860,804,56,2018,58462,0.3751,39.3,2637,4605,4103,57,10,0,40,395,"Lincoln County, Nevada",32,017,32017
451732.0,7295.0,17839.0,2477.0,4175,228234,182180,53011,33063,30298,2765,129169,97608,83193,14415,182180,64791,0.4605,38.7,197371,454261,361311,28427,21940,2352,11274,28957,"Washoe County, Nevada",32,031,32031
54215.0,3227.0,1864.0,168.0,200,25172,22755,7957,4505,4319,186,14798,10891,9824,1067,22755,55718,0.4539,38.5,23974,52717,42077,2791,2265,241,1502,3841,"Carson City, Nevada",32,510,32510
148460.0,6172.0,3304.0,623.0,259,78708,58452,18266,11532,10680,852,40186,31801,28098,3703,58452,75737,0.4267,38.3,64960,146402,131040,4118,2930,179,477,7658,"Merrimack County, New Hampshire",33,013,33013
60377.0,1980.0,1231.0,43.0,49,30807,25052,8722,5646,5262,384,16330,12695,11324,1371,25052,69447,0.4395,38.3,38607,60163,54476,973,714,46,65,3889,"Belknap County, New Hampshire",33,001,33001
128099.0,5233.0,6164.0,780.0,1200,67542,48982,13063,8390,8032,358,35919,27788,23178,4610,48982,72960,0.4291,37.0,53883,127806,114363,2642,3166,243,469,6923,"Strafford County, New Hampshire",33,017,33017
616628.0,14239.0,8893.0,2660.0,26450,312432,235362,76248,47213,44956,2257,159114,126324,117058,9266,235362,99733,0.4764,38.6,261579,617769,515895,49935,16889,3394,14316,17340,"Monmouth County, New Jersey",34,025,34025
140255.0,4193.0,1280.0,245.0,1229,74038,53322,16274,10994,10536,458,37048,30097,27756,2341,53322,94520,0.4098,38.5,62418,140417,125129,7479,2288,457,572,4492,"Sussex County, New Jersey",34,037,34037
786565.0,14838.0,13568.0,6417.0,80228,369683,285908,76579,45410,43315,2095,209329,152253,140946,11307,285908,61510,0.5551,38.1,317314,783478,534116,105194,54731,11023,43546,34868,"Essex County, New Jersey",34,013,34013
288339.0,10145.0,3469.0,630.0,3444,146423,104908,31626,20207,19435,772,73282,59256,54301,4955,104908,87283,0.4174,38.4,113485,290013,263581,10392,3446,496,1643,10455,"Gloucester County, New Jersey",34,015,34015
496901.0,10609.0,4233.0,3588.0,20402,239128,165429,50854,33703,32260,1443,114575,93081,87589,5492,165429,69688,0.4701,37.8,177090,500290,324542,76045,37189,9227,31431,21856,"Passaic County, New Jersey",34,031,34031
921541.0,14212.0,16028.0,7275.0,73916,469569,339856,109765,72112,69335,2777,230091,186314,174984,11330,339856,101144,0.4759,39.0,357828,924277,612771,169107,72894,13029,30437,26039,"Bergen County, New Jersey",34,003,34003
105155.0,3554.0,1724.0,332.0,820,54015,41587,13447,7903,7559,344,28140,22037,20169,1868,41587,81307,0.4185,38.6,45473,105047,90940,6029,2115,480,1669,3814,"Warren County, New Jersey",34,041,34041
441947.0,12969.0,9323.0,2306.0,7684,223799,166391,52643,33914,32539,1375,113748,90450,83563,6887,166391,87416,0.4336,38.8,179414,430869,375337,25951,10975,1516,3508,13582,"Burlington County, New Jersey",34,005,34005
23621.0,672.0,475.0,246.0,63,7475,8904,3509,1776,1618,158,5395,3934,3730,204,8904,29360,0.4726,39.9,11287,23663,18110,1353,2156,101,535,1408,"Luna County, New Mexico",35,029,35029
32555.0,846.0,742.0,101.0,262,13553,12103,5474,3050,2837,213,6629,4269,3934,335,12103,38329,0.4874,35.7,20916,32601,28196,759,469,116,653,2408,"Taos County, New Mexico",35,055,35055
12086.0,530.0,620.0,8.0,5,4868,5853,2420,1368,1276,92,3433,2280,2001,279,5853,36302,0.4291,39.4,10284,11611,10649,193,77,4,75,613,"Colfax County, New Mexico",35,007,35007
441.0,12.0,12.0,3.0,0,170,211,138,63,61,2,73,45,44,1,211,29375,0.6097,40.0,567,438,395,9,0,0,20,14,"Harding County, New Mexico",35,021,35021
8264.0,121.0,179.0,0.0,7,2988,3040,1401,615,597,18,1639,1056,983,73,3040,29035,0.4462,36.2,5690,8263,7505,80,179,12,2,485,"Quay County, New Mexico",35,037,35037
10594.0,88.0,184.0,50.0,0,3865,3986,1248,693,672,21,2738,1940,1920,20,3986,33784,0.5001,38.3,5276,10494,8895,5,25,57,38,1474,"Noxubee County, Mississippi",28,103,28103
28022.0,2046.0,485.0,56.0,39,11911,10324,3405,2302,2116,186,6919,5822,5464,358,10324,51030,0.4222,39.4,11514,27941,24329,114,87,133,137,3141,"Tate County, Mississippi",28,137,28137
33910.0,1318.0,126.0,26.0,10,12215,12488,3881,2520,2474,46,8607,6359,6038,321,12488,38304,0.4624,40.1,15057,33960,29417,72,73,0,318,4080,"Panola County, Mississippi",28,107,28107
12227.0,424.0,229.0,0.0,11,5038,5181,1987,1214,1191,23,3194,2314,2159,155,5181,41464,0.402,39.9,6519,12137,10565,47,10,0,0,1515,"Yalobusha County, Mississippi",28,161,28161
10446.0,439.0,233.0,82.0,32,5346,4577,1558,838,793,45,3019,2137,1928,209,4577,49870,0.4035,38.9,5200,10318,9875,111,96,22,2,212,"Winnebago County, Iowa",19,189,19189
11491.0,270.0,335.0,82.0,10,6088,5030,1692,972,941,31,3338,2492,2235,257,5030,58000,0.4265,40.2,5580,11398,10685,95,45,2,77,494,"Shelby County, Iowa",19,165,19165
12328.0,399.0,176.0,2.0,33,5201,5353,2135,1101,1066,35,3218,2264,2122,142,5353,40167,0.4919,38.8,6625,12348,11317,47,15,0,50,919,"Appanoose County, Iowa",19,007,19007
16063.0,568.0,312.0,11.0,5,8432,6780,2087,1267,1239,28,4693,3743,3395,348,6780,61443,0.4429,39.4,7349,15914,15204,92,34,0,46,538,"Iowa County, Iowa",19,095,19095
15119.0,696.0,540.0,7.0,2,6891,6280,2242,1260,1192,68,4038,2798,2638,160,6280,51867,0.4179,39.5,7190,14172,13251,153,144,0,58,566,"Page County, Iowa",19,145,19145
20147.0,650.0,754.0,87.0,1,11428,8257,2818,1539,1482,57,5439,4287,3867,420,8257,65263,0.4045,38.0,8976,20008,19325,123,173,0,88,299,"Winneshiek County, Iowa",19,191,19191
92334.0,1848.0,3175.0,326.0,311,46537,36799,11047,6663,6380,283,25752,19698,17737,1961,36799,60065,0.4241,39.5,39936,92409,84127,1536,1380,223,772,4371,"Pottawattamie County, Iowa",19,155,19155
39492.0,1109.0,470.0,229.0,21,18572,15419,4390,2545,2409,136,11029,8539,7536,1003,15419,56437,0.4045,39.2,16793,38887,32219,1502,2866,154,854,1292,"Marshall County, Iowa",19,127,19127
26058.0,1089.0,712.0,20.0,33,13838,10954,3246,1976,1843,133,7708,5855,5475,380,10954,64000,0.4056,39.5,11963,25891,24842,200,117,0,50,682,"Boone County, Iowa",19,015,19015
19798.0,563.0,557.0,27.0,32,10176,7524,2093,1187,1169,18,5431,4177,3845,332,7524,57125,0.4092,38.9,8285,19785,15133,1150,1733,88,1052,629,"Buena Vista County, Iowa",19,021,19021
9054.0,262.0,148.0,13.0,45,4575,3810,1275,645,630,15,2535,1917,1793,124,3810,55060,0.397,40.3,4364,9041,8438,30,28,0,10,535,"Howard County, Iowa",19,089,19089
10611.0,673.0,145.0,29.0,8,5265,4452,1596,971,942,29,2856,2325,2148,177,4452,61161,0.4169,39.0,5804,10570,10035,17,137,5,31,345,"Guthrie County, Iowa",19,077,19077
9419.0,419.0,76.0,7.0,4,4593,4174,1368,777,758,19,2806,2055,1861,194,4174,54575,0.4256,40.7,4744,9447,8992,41,55,4,117,238,"Humboldt County, Iowa",19,091,19091
15875.0,647.0,260.0,6.0,9,8419,6462,1972,1079,1058,21,4490,3736,3641,95,6462,66316,0.4412,40.5,6980,15844,15220,67,30,0,99,428,"Madison County, Iowa",19,121,19121
,,,,882,34835,30758,12846,8061,7643,418,17912,13475,12647,828,30758,35928,0.5739,37.7,40073,86512,75751,3041,1689,77,393,5561,"Guaynabo Municipio, Puerto Rico",72,061,72061
,,,,98,9529,12298,4843,3166,2915,251,7455,5567,5314,253,12298,19430,0.545,34.3,18437,30976,27970,294,316,0,136,2260,"Fajardo Municipio, Puerto Rico",72,053,72053
,,,,128,7857,8488,3308,2298,2256,42,5180,4131,3950,181,8488,19279,0.5183,35.4,10698,25638,23594,65,62,0,29,1888,"Aguas Buenas Municipio, Puerto Rico",72,007,72007
,,,,19,12410,14160,5257,3762,3669,93,8903,6929,6746,183,14160,17715,0.5043,33.3,17113,39888,37125,138,22,0,16,2587,"Hatillo Municipio, Puerto Rico",72,065,72065
,,,,14,7623,7367,2414,1443,1361,82,4953,3823,3596,227,7367,19827,0.4927,34.6,9194,21757,19844,10,0,0,23,1880,"Santa Isabel Municipio, Puerto Rico",72,133,72133
,,,,194,18065,29682,12668,7553,7107,446,17014,12073,10730,1343,29682,14236,0.6147,33.4,40869,74713,69213,674,884,0,189,3753,"Mayagüez Municipio, Puerto Rico",72,097,72097
,,,,187,15612,15635,6140,4283,4158,125,9495,7640,7093,547,15635,22669,0.4762,35.6,22868,49093,44895,291,240,0,98,3569,"Río Grande Municipio, Puerto Rico",72,119,72119
,,,,26,8376,8848,3807,2595,2530,65,5041,3965,3779,186,8848,19919,0.4884,34.0,12530,26847,25594,80,5,0,21,1147,"Añasco Municipio, Puerto Rico",72,011,72011
,,,,401,7589,8706,3462,2170,2079,91,5244,4121,3935,186,8706,17448,0.5637,35.8,10763,24217,21870,382,300,56,50,1559,"Cataño Municipio, Puerto Rico",72,033,72033
,,,,1,3189,5515,2623,1630,1596,34,2892,2024,1829,195,5515,12995,0.513,32.7,9358,16280,15540,21,12,0,0,707,"Guánica Municipio, Puerto Rico",72,055,72055
,,,,280,7485,8508,3192,2237,2097,140,5316,4277,3947,330,8508,17852,0.4922,34.8,11470,25746,23096,153,108,21,114,2254,"Loíza Municipio, Puerto Rico",72,087,72087
,,,,13,10185,12376,4436,3156,2969,187,7940,6654,6197,457,12376,21667,0.5011,37.4,15327,37466,35032,44,167,0,29,2194,"Las Piedras Municipio, Puerto Rico",72,085,72085
,,,,100,14834,18721,7481,4948,4618,330,11240,9056,8598,458,18721,19617,0.5012,35.9,24612,51992,46774,95,179,20,94,4830,"Vega Baja Municipio, Puerto Rico",72,145,72145
6766.0,349.0,58.0,0.0,8,2434,2784,1108,685,672,13,1676,1197,1129,68,2784,32397,0.5807,40.5,4401,6668,6050,26,48,20,38,486,"Lafayette County, Arkansas",05,073,05073
18347.0,466.0,142.0,0.0,0,6481,7485,2568,1523,1466,57,4917,3543,3370,173,7485,29320,0.4944,40.2,10211,18450,16810,81,0,0,0,1559,"Phillips County, Arkansas",05,107,05107
21198.0,830.0,511.0,92.0,6,8989,7503,2444,1625,1592,33,5059,4185,3950,235,7503,43923,0.4367,40.7,9840,21161,18045,446,1001,91,592,986,"Yell County, Arkansas",05,149,05149
10702.0,178.0,59.0,28.0,0,4026,4419,1347,844,782,62,3072,2208,2045,163,4419,43184,0.451,40.4,5824,10780,9305,142,151,131,355,696,"Bradley County, Arkansas",05,011,05011
19933.0,240.0,386.0,61.0,19,7072,8243,3079,2076,2037,39,5164,3963,3635,328,8243,37974,0.492,39.4,10135,19971,17429,167,283,44,379,1669,"Polk County, Arkansas",05,113,05113
23559.0,349.0,480.0,7.0,0,9365,9658,3272,1973,1923,50,6386,4341,4086,255,9658,35425,0.4577,39.3,13095,23484,21663,64,94,0,0,1663,"Ouachita County, Arkansas",05,103,05103
12250.0,368.0,275.0,24.0,0,4774,5363,1799,1092,1043,49,3564,2635,2480,155,5363,45113,0.4494,39.9,6512,12189,11405,28,0,0,16,740,"Little River County, Arkansas",05,081,05081
43106.0,1102.0,2360.0,0.0,100,17537,16426,4941,3053,2887,166,11485,8796,8221,575,16426,43371,0.466,39.1,19568,42276,37748,172,370,174,122,3690,"Miller County, Arkansas",05,091,05091
77602.0,3231.0,2778.0,340.0,71,32106,29055,8708,5430,5281,149,20347,15397,14506,891,29055,44029,0.4609,39.2,33779,78254,70423,513,792,203,853,5470,"White County, Arkansas",05,145,05145
63512.0,3801.0,1138.0,168.0,163,23281,25660,10532,6000,5147,853,15128,11347,10056,1291,25660,47040,0.4817,37.0,34845,63494,54391,2393,2196,187,742,3585,"Lake County, California",06,033,06033
75213.0,4509.0,1954.0,462.0,288,30628,26354,6897,4421,4057,364,19457,15909,14329,1580,26354,58054,0.426,38.9,28586,74309,60741,4851,3335,415,895,4072,"Yuba County, California",06,115,06115
30449.0,5456.0,672.0,127.0,26,8340,9280,3108,1915,1833,82,6172,4751,4335,416,9280,56352,0.4171,38.7,12783,21190,19612,372,274,7,41,884,"Lassen County, California",06,035,06035
495554.0,16257.0,5608.0,2590.0,4526,249638,189374,68097,41048,36712,4336,121277,96316,83729,12587,189374,81018,0.4536,37.1,207713,495516,397013,33802,34517,2080,11317,16787,"Sonoma County, California",06,097,06097
177994.0,4288.0,1123.0,1404.0,555,59343,44829,14754,10608,10199,409,30075,24986,23948,1038,44829,47622,0.4704,37.6,57690,170981,109171,26517,21535,1763,4146,7849,"Imperial County, California",06,025,06025
1639187.0,60993.0,22697.0,21789.0,123507,781901,577177,156177,102837,96078,6759,421000,333263,288598,44665,577177,99406,0.4616,38.3,608096,1647749,1075694,282450,217529,7650,29393,35033,"Alameda County, California",06,001,06001
138406.0,4837.0,1539.0,634.0,1201,69238,48705,17778,10930,10316,614,30927,25176,22797,2379,48705,88596,0.4712,37.5,55602,137806,103011,14097,12626,675,3220,4177,"Napa County, California",06,055,06055
2994.0,111.0,19.0,0.0,4,1195,1319,609,396,382,14,710,483,455,28,1319,52148,0.4594,36.8,2365,3013,2682,16,51,0,1,263,"Sierra County, California",06,091,06091
214986.0,16597.0,2933.0,3858.0,4068,97220,74296,18779,12157,11433,724,55517,45358,35684,9674,74296,70228,0.4928,35.9,77947,215938,160759,22208,22505,834,4749,4883,"Yolo County, California",06,113,06113
98262.0,3873.0,897.0,451.0,151,42907,40855,17611,11583,10515,1068,23244,17379,15633,1746,40855,66096,0.4697,36.5,53989,98232,87867,2519,1413,83,690,5660,"Nevada County, California",06,057,06057
86126.0,2519.0,1427.0,207.0,108,36446,34408,13470,8000,6952,1048,20938,15773,13958,1815,34408,51416,0.4704,37.1,40960,86352,70954,3367,4618,408,2334,4671,"Mendocino County, California",06,045,06045
9969032.0,104983.0,100949.0,73219.0,279730,4811408,3316795,930438,637651,602273,35378,2386357,1827840,1608666,219174,3316795,68044,0.5002,38.0,3542800,10012895,6200215,1677498,1170001,106196,461207,397778,"Los Angeles County, California",06,037,06037
1906337.0,46063.0,35223.0,34411.0,42965,966853,640215,170907,122052,115371,6681,469308,388073,344367,43706,640215,124055,0.4664,38.7,672495,1917643,1130304,389420,315515,11257,36302,34845,"Santa Clara County, California",06,085,06085
43062.0,2083.0,726.0,57.0,38,16123,19240,7913,4559,4137,422,11327,8247,7259,988,19240,45241,0.4772,37.6,24118,43356,38826,1265,699,152,223,2191,"Siskiyou County, California",06,093,06093
27082.0,2266.0,676.0,1.0,33,8838,9945,3488,2221,1987,234,6457,4600,4148,452,9945,45283,0.4743,36.7,11379,24588,21368,900,713,0,162,1445,"Del Norte County, California",06,015,06015
19354.0,558.0,345.0,270.0,22,8243,8231,3550,2313,2241,72,4681,3618,3118,500,8231,55771,0.4231,38.0,11064,18227,15904,389,118,0,80,1736,"Chaffee County, Colorado",08,015,08015
58447.0,2252.0,1786.0,310.0,1279,30972,21498,5248,3644,3353,291,16250,13362,11887,1475,21498,75937,0.4031,39.2,24001,58401,44939,1860,2233,440,4139,4790,"Garfield County, Colorado",08,045,08045
568925.0,30665.0,17977.0,2168.0,10567,311795,232284,64454,40714,38493,2221,167830,128930,110925,18005,232284,82986,0.4329,38.8,240956,568063,506841,18580,11676,1304,5035,24627,"Jefferson County, Colorado",08,059,08059
6306.0,453.0,253.0,13.0,23,2768,2301,668,319,313,6,1633,1255,1152,103,2301,54357,0.4096,38.8,3391,6252,5630,48,50,4,86,434,"Rio Blanco County, Colorado",08,103,08103
8014.0,362.0,93.0,17.0,2,2915,3183,1163,570,568,2,2020,1478,1413,65,3183,36084,0.4533,38.9,4433,8089,7125,64,52,5,22,821,"Conejos County, Colorado",08,021,08021
497326.0,27806.0,11318.0,2676.0,9205,258075,166450,35579,23638,22567,1071,130871,105735,94469,11266,166450,71202,0.4052,39.4,173200,500418,397550,25882,26367,2508,22027,26084,"Adams County, Colorado",08,001,08001
54234.0,2257.0,1650.0,322.0,1103,33587,18171,4086,3008,2783,225,14085,11297,9239,2058,18171,84790,0.4694,39.8,32461,54502,41086,2368,3665,396,3149,3838,"Eagle County, Colorado",08,037,08037
12971.0,615.0,498.0,145.0,61,6128,5366,1275,687,671,16,4091,3162,2811,351,5366,57229,0.4418,38.5,6300,12968,10566,149,227,214,317,1495,"Moffat County, Colorado",08,081,08081
1957.0,84.0,56.0,33.0,0,832,774,249,112,112,0,525,376,373,3,774,53977,0.4367,45.8,989,1983,1673,53,25,0,105,127,"Cheyenne County, Colorado",08,017,08017
224583.0,7525.0,7482.0,1634.0,469,100094,89527,24326,14112,13538,574,65201,45439,41617,3822,89527,50124,0.4928,38.6,104697,221812,192222,3224,4107,528,2737,18994,"Montgomery County, Alabama",01,101,01101
94420.0,3130.0,1609.0,229.0,169,38759,34883,10930,6680,6498,182,23953,18860,17517,1343,34883,45983,0.4707,39.2,40597,94805,79595,1296,2254,241,3243,8176,"Marshall County, Alabama",01,095,01095
57191.0,1164.0,484.0,95.0,28,21690,20847,6769,4427,4227,200,14078,10957,10647,310,20847,49358,0.457,41.0,24323,57217,49426,685,947,281,706,5172,"Blount County, Alabama",01,009,01009
16994.0,485.0,227.0,51.0,0,6811,6630,2474,1509,1491,18,4156,3230,3014,216,6630,50017,0.4407,40.0,9155,16813,15047,89,23,9,25,1620,"Henry County, Alabama",01,067,01067
358386.0,9369.0,11407.0,1791.0,312,175522,148189,38163,23826,23222,604,110026,79532,72325,7207,148189,65449,0.462,38.6,161577,356952,312416,9241,5642,816,4048,24789,"Madison County, Alabama",01,089,01089
54699.0,2015.0,1548.0,94.0,162,24635,21397,6008,3789,3648,141,15389,12135,11428,707,21397,58731,0.4542,40.5,23493,54552,49544,720,432,30,117,3709,"Autauga County, Alabama",01,001,01001
40041.0,1362.0,695.0,23.0,15,14931,16205,5892,3668,3535,133,10313,7983,7648,335,16205,45828,0.4689,40.5,22421,40016,36498,188,65,19,322,2924,"Tallapoosa County, Alabama",01,123,01123
26143.0,794.0,406.0,9.0,0,10030,10383,3655,2331,2300,31,6728,5115,4602,513,10383,41732,0.44,40.4,12869,26143,22610,162,67,56,108,3140,"Geneva County, Alabama",01,061,01061
10512.0,311.0,45.0,25.0,9,2948,3854,1402,827,758,69,2452,1669,1526,143,3854,31014,0.4887,37.9,5777,10413,9278,1,0,32,30,1072,"Wilcox County, Alabama",01,131,01131
5659.0,162.0,373.0,180.0,31,3772,1187,187,114,111,3,1000,730,621,109,1187,87466,0.3514,57.4,1983,5473,2528,831,1155,95,289,575,"Aleutians West Census Area, Alaska",02,016,02016
858.0,54.0,40.0,1.0,2,473,314,66,40,33,7,248,177,161,16,314,79808,0.3916,47.7,952,860,670,4,10,2,3,171,"Bristol Bay Borough, Alaska",02,060,02060
13270.0,616.0,717.0,230.0,2,7168,4261,838,624,543,81,3423,2639,2424,215,4261,85839,0.372,42.8,5422,12812,8379,1111,1119,97,334,1772,"Kodiak Island Borough, Alaska",02,150,02150
7565.0,139.0,238.0,4.0,27,2528,1795,410,329,324,5,1385,1107,994,113,1795,60906,0.4469,42.9,2745,7694,5647,50,19,15,31,1932,"Northwest Arctic Borough, Alaska",02,188,02188
52503.0,2657.0,1003.0,114.0,57,20802,20804,7220,4266,4124,142,13584,10322,9561,761,20804,43285,0.4627,39.1,23418,52219,45805,469,430,20,551,4944,"McMinn County, Tennessee",47,107,47107
32621.0,1461.0,328.0,29.0,21,14474,12324,3658,2277,2175,102,8666,6946,6449,497,12324,53197,0.4045,40.8,13669,32607,29640,85,428,48,365,2041,"Marshall County, Tennessee",47,117,47117
32118.0,1259.0,448.0,125.0,23,12639,12177,4184,2648,2560,88,7993,6124,5675,449,12177,42206,0.4506,38.1,14673,32372,28877,104,290,94,359,2648,"Rhea County, Tennessee",47,143,47143
21636.0,206.0,226.0,53.0,10,7897,8664,2629,1593,1488,105,6035,4995,4571,424,8664,38864,0.4584,39.8,10018,21638,19319,39,20,0,10,2250,"Scott County, Tennessee",47,151,47151
75318.0,3624.0,1866.0,251.0,91,31794,30541,10656,6644,6337,307,19885,15361,14213,1148,30541,50392,0.4651,39.0,34971,75092,65961,1041,1060,34,509,6487,"Anderson County, Tennessee",47,001,47001
18081.0,805.0,370.0,7.0,29,6919,7443,2688,1690,1646,44,4755,3542,3283,259,7443,36520,0.4208,38.6,9045,18034,16469,129,45,9,23,1359,"Fentress County, Tennessee",47,049,47049
48705.0,1730.0,504.0,83.0,8,20053,19320,6192,3586,3442,144,13128,10043,9545,498,19320,43171,0.4505,39.3,22592,48099,43542,165,178,72,260,3882,"Gibson County, Tennessee",47,053,47053
25332.0,840.0,92.0,1.0,52,7879,8891,3074,1974,1927,47,5817,4147,3889,258,8891,40304,0.4381,38.1,10997,21590,19257,106,64,0,2,2161,"Hardeman County, Tennessee",47,069,47069
51867.0,2010.0,1270.0,70.0,34,21039,20669,9062,6072,5942,130,11607,9162,8673,489,20669,58065,0.4513,39.1,23083,51966,44063,1328,1224,32,1204,4115,"Loudon County, Tennessee",47,105,47105
312165.0,15418.0,9633.0,974.0,561,165596,111676,22930,15531,14845,686,88746,72401,63235,9166,111676,67429,0.4065,39.2,118691,313400,270836,8963,6796,1094,6430,19281,"Rutherford County, Tennessee",47,149,47149
19543.0,841.0,144.0,12.0,20,9002,7603,2285,1478,1431,47,5318,4147,3978,169,7603,48068,0.5148,39.3,8794,19546,17792,111,165,7,68,1403,"Smith County, Tennessee",47,159,47159
135447.0,5555.0,3491.0,491.0,560,67171,49664,14446,10152,9834,318,35218,29687,28016,1671,49664,75991,0.4095,40.0,53339,135542,122005,2882,2181,517,1141,6816,"Wilson County, Tennessee",47,189,47189
17678.0,508.0,543.0,138.0,35,7190,7658,2956,1680,1628,52,4702,3719,3325,394,7658,41890,0.4335,39.8,8903,17440,15428,106,145,45,271,1445,"Unicoi County, Tennessee",47,171,47171
19301.0,607.0,559.0,69.0,11,7533,7566,3649,2452,2319,133,3917,2732,2531,201,7566,46216,0.4648,37.8,18156,19257,16179,614,448,96,348,1572,"Lincoln County, New Mexico",35,027,35027
64336.0,1552.0,1705.0,380.0,284,26631,23284,7209,4250,4039,211,16075,12277,11692,585,23284,43359,0.4608,39.9,27279,64044,51344,3215,3055,443,1469,4518,"Chaves County, New Mexico",35,005,35005
69170.0,1266.0,1902.0,106.0,36,28672,22523,5574,3637,3491,146,16949,13709,13097,612,22523,60546,0.4423,43.1,26610,68221,51295,3007,5034,440,3237,5208,"Lea County, New Mexico",35,025,35025
148188.0,3236.0,4165.0,460.0,727,69747,61921,23853,14623,13326,1297,38068,26219,23452,2767,61921,61200,0.4882,37.2,72988,147742,121365,5381,4977,741,6776,8502,"Santa Fe County, New Mexico",35,049,35049
4062.0,288.0,77.0,0.0,0,1480,1395,593,240,220,20,802,570,523,47,1395,35884,0.4976,41.4,2347,3485,2891,67,43,31,83,370,"Union County, New Mexico",35,059,35059
10973.0,418.0,95.0,32.0,15,3367,5555,2874,1391,1284,107,2681,1600,1521,79,5555,29755,0.5346,36.9,8555,10772,9766,179,257,0,64,506,"Sierra County, New Mexico",35,051,35051
16699.0,397.0,336.0,138.0,17,5443,4520,1703,1004,910,94,2817,1694,1496,198,4520,42083,0.4472,35.9,8234,16748,14287,383,707,64,3,1304,"Socorro County, New Mexico",35,053,35053
18536.0,1303.0,717.0,384.0,30,8021,6814,1828,1052,990,62,4986,3690,3132,558,6814,42702,0.4456,38.3,8518,18380,15258,409,702,158,826,1027,"Roosevelt County, New Mexico",35,041,35041
213668.0,5011.0,7481.0,1386.0,391,88174,77842,23210,15557,14959,598,54632,42589,37895,4694,77842,40973,0.4918,37.3,87897,212563,162882,13495,14330,1530,7618,12708,"Doña Ana County, New Mexico",35,013,35013
18444.0,353.0,911.0,195.0,332,9666,7931,2256,1287,1225,62,5675,4025,3732,293,7931,121324,0.3909,38.9,8384,18537,16234,1121,597,53,42,490,"Los Alamos County, New Mexico",35,028,35028
38732.0,1257.0,507.0,22.0,121,14015,12730,4591,2709,2443,266,8139,5517,5133,384,12730,39952,0.5084,39.4,20184,38976,34263,691,461,139,347,3075,"Rio Arriba County, New Mexico",35,039,35039
27450.0,918.0,440.0,88.0,91,9439,11609,4217,1908,1772,136,7392,5030,4657,373,11609,30946,0.504,36.1,15984,27140,24824,317,456,11,202,1330,"San Miguel County, New Mexico",35,047,35047
75170.0,2550.0,1365.0,238.0,289,29303,27010,9292,6088,5749,339,17718,13777,12651,1126,27010,48945,0.4353,37.3,31208,74556,65320,1697,1445,479,1495,4120,"Valencia County, New Mexico",35,061,35061
15262.0,627.0,642.0,32.0,2,5402,5644,2180,1190,1140,50,3464,2636,2506,130,5644,36120,0.4594,38.5,8026,15216,13992,170,146,112,81,715,"Torrance County, New Mexico",35,057,35057
670641.0,11058.0,17896.0,3419.0,5420,317562,267699,76129,45166,42160,3006,191570,132869,116649,16220,267699,53329,0.477,37.9,293787,670723,566802,26718,21879,2871,16341,36112,"Bernalillo County, New Mexico",35,001,35001
65183.0,1246.0,4726.0,2119.0,219,25668,23634,7741,4646,4403,243,15893,11120,10165,955,23634,41988,0.4724,39.0,31745,60389,50919,2330,2016,326,926,3872,"Otero County, New Mexico",35,035,35035
26601.0,1344.0,562.0,33.0,22,9013,8708,2951,1786,1611,175,5757,4639,4388,251,8708,39413,0.4545,38.3,11397,25525,22917,139,139,52,300,1978,"Cibola County, New Mexico",35,006,35006
2029.0,52.0,30.0,0.0,0,624,672,314,90,86,4,358,270,246,24,672,31625,0.4282,38.0,1092,2015,1914,17,2,0,5,77,"De Baca County, New Mexico",35,011,35011
4335.0,295.0,15.0,5.0,0,1240,1384,751,280,280,0,633,354,321,33,1384,24798,0.4691,35.2,2670,3650,3419,7,38,10,7,169,"Guadalupe County, New Mexico",35,019,35019
3514.0,0.0,80.0,0.0,0,876,1325,906,566,473,93,419,322,318,4,1325,41910,0.383,34.0,3756,3519,3094,38,12,0,38,337,"Catron County, New Mexico",35,003,35003
1415162.0,30367.0,10009.0,12949.0,348100,582554,503829,137182,77773,73610,4163,366647,269314,251751,17563,503829,40088,0.5118,36.8,529796,1414023,866147,236741,190064,15353,60465,45253,"Bronx County, New York",36,005,36005
458265.0,10588.0,9134.0,4273.0,6338,218911,185324,55320,31099,29179,1920,130004,96174,82920,13254,185324,61359,0.4654,37.7,208376,457795,406417,19245,15204,786,1874,14269,"Onondaga County, New York",36,067,36067
79939.0,5055.0,1248.0,219.0,246,34916,31301,9286,5501,5148,353,22015,16601,14057,2544,31301,56365,0.4278,36.9,36576,75998,70223,1634,1172,21,201,2747,"Clinton County, New York",36,019,36019
33960.0,2024.0,418.0,65.0,92,14992,13564,4505,2676,2458,218,9059,6965,6079,886,13564,54545,0.4376,38.7,16361,31683,28434,424,209,22,102,2492,"Seneca County, New York",36,099,36099
97965.0,3244.0,571.0,267.0,3680,49793,34854,11516,8000,7543,457,23338,19068,17940,1128,34854,104486,0.4229,38.4,38620,98320,83668,7531,3488,330,1371,1932,"Putnam County, New York",36,079,36079
61403.0,1931.0,337.0,30.0,185,28042,24524,8600,5019,4739,280,15924,12084,10878,1206,24524,54646,0.4152,37.4,33831,61428,56912,1011,449,33,104,2919,"Herkimer County, New York",36,043,36043
108813.0,4578.0,2214.0,462.0,360,54024,44787,15100,8730,8044,686,29687,22680,20350,2330,44787,64944,0.4511,38.2,50857,108596,101338,2128,1572,25,379,3154,"Ontario County, New York",36,069,36069
95303.0,2200.0,1247.0,209.0,263,42052,39861,12645,7624,7133,491,27216,20339,18423,1916,39861,53663,0.4533,38.4,49585,95301,87282,1221,1599,81,144,4974,"Steuben County, New York",36,101,36101
4450.0,127.0,29.0,10.0,7,1767,1157,553,343,334,9,604,491,452,39,1157,58675,0.3979,36.0,8948,4493,4143,70,4,0,5,271,"Hamilton County, New York",36,041,36041
127290.0,3501.0,2003.0,354.0,182,54703,53075,17800,10136,9546,590,35275,25618,22803,2815,53075,46820,0.4519,37.8,67645,126145,116989,1351,1050,83,218,6454,"Chautauqua County, New York",36,013,36013
2554193.0,46623.0,28598.0,22335.0,733657,1197935,958567,266233,166723,158773,7950,692334,512916,430233,82683,958567,60231,0.5264,38.7,1044493,2576511,1571448,538110,279114,29149,84987,73703,"Kings County, New York",36,047,36047
48113.0,1565.0,950.0,51.0,84,22388,20030,6801,4251,4039,212,13229,10414,9606,808,20030,62999,0.4177,38.2,22527,48307,45409,529,358,1,42,1968,"Tioga County, New York",36,107,36107
40566.0,2165.0,204.0,133.0,118,17502,16563,5275,3167,2985,182,11288,8838,7970,868,16563,52620,0.4208,38.9,18584,38200,35449,503,298,26,158,1766,"Orleans County, New York",36,073,36073
226233.0,8543.0,6482.0,976.0,877,119605,94406,28166,17548,16726,822,66240,51616,45980,5636,94406,84291,0.4188,38.9,106029,225586,206718,6378,4981,153,550,6806,"Saratoga County, New York",36,091,36091
59902.0,1428.0,899.0,217.0,765,28927,24966,9401,5756,5372,384,15565,11820,10356,1464,24966,66787,0.4663,38.4,33486,58739,52735,2054,1256,41,623,2030,"Columbia County, New York",36,021,36021
26264.0,629.0,267.0,42.0,45,11754,10247,3168,2069,1949,120,7079,5616,5018,598,10247,54524,0.4002,39.8,15679,26263,24526,93,194,0,114,1336,"Lewis County, New York",36,049,36049
959081.0,26181.0,11148.0,7915.0,108564,471725,349292,113607,69255,66107,3148,235685,185720,173701,12019,349292,96610,0.5405,39.0,374923,956650,690718,130195,79976,7152,28619,19990,"Westchester County, New York",36,119,36119
44695.0,1585.0,463.0,70.0,259,19552,18968,7537,4366,4025,341,11431,8342,7364,978,18968,49544,0.4412,37.8,31609,44562,40522,1018,729,47,161,2085,"Delaware County, New York",36,025,36025
48721.0,1703.0,656.0,334.0,160,21234,19660,6338,3589,3271,318,13322,10154,9132,1022,19660,49462,0.4472,37.9,23496,48528,43676,1090,684,24,84,2970,"Montgomery County, New York",36,057,36057
469952.0,8524.0,2248.0,1852.0,62647,211171,166246,54563,36925,35611,1314,111683,91548,87264,4284,166246,82783,0.4551,37.8,180325,470833,352170,70674,27610,2966,8479,8934,"Richmond County, New York",36,085,36085
107878.0,4692.0,1367.0,348.0,152,42818,41933,13010,7364,6842,522,28923,22256,19621,2635,41933,50940,0.4421,36.4,53194,105260,95481,1704,1799,84,194,5998,"St. Lawrence County, New York",36,089,36089
101946.0,5335.0,6761.0,2323.0,3286,49101,39618,10049,6345,5701,644,29569,20542,14749,5793,39618,60240,0.496,34.5,43471,101802,85654,5245,7421,158,383,2941,"Tompkins County, New York",36,109,36109
63803.0,2959.0,754.0,124.0,296,31330,28015,9707,5770,5477,293,18308,13117,11350,1767,28015,61024,0.4358,38.0,39952,63639,59167,1272,735,48,107,2310,"Warren County, New York",36,113,36113
47313.0,1913.0,617.0,86.0,206,22493,17745,5362,3445,3244,201,12383,9742,8150,1592,17745,56023,0.4434,36.9,20737,47408,45062,608,243,2,62,1431,"Cortland County, New York",36,023,36023
291402.0,11465.0,4983.0,1445.0,7839,142352,108413,35056,22401,21081,1320,73357,56752,51620,5132,108413,81219,0.4497,37.8,120789,285513,243927,18437,9708,1096,3458,8887,"Dutchess County, New York",36,027,36027
8507.0,295.0,335.0,24.0,18,4270,4030,1402,842,805,37,2628,1957,1830,127,4030,50903,0.4606,40.7,4844,8461,7259,119,130,0,0,953,"Platte County, Wyoming",56,031,56031
30004.0,1037.0,809.0,37.0,10,14985,13251,4374,2922,2569,353,8877,6305,5549,756,13251,60807,0.4313,39.6,14915,29711,26073,314,173,31,93,3027,"Sheridan County, Wyoming",56,033,56033
11737.0,329.0,728.0,13.0,27,5003,4475,1686,1027,976,51,2789,2144,2030,114,4475,52804,0.4071,40.0,5474,11651,9675,77,79,67,110,1643,"Big Horn County, Wyoming",56,003,56003
7317.0,183.0,354.0,56.0,35,3374,2919,942,595,537,58,1977,1521,1469,52,2919,65132,0.4008,42.3,3656,7397,6675,48,21,0,67,586,"Crook County, Wyoming",56,011,56011
28913.0,552.0,1546.0,38.0,52,13713,12160,4498,2986,2854,132,7662,5813,5312,501,12160,63582,0.4373,39.3,14452,28957,24979,388,272,29,29,3260,"Park County, Wyoming",56,029,56029
37974.0,2287.0,3017.0,448.0,284,20741,15944,3188,1699,1605,94,12756,9198,5973,3225,15944,49322,0.4697,37.0,19266,38169,32703,821,1503,87,371,2684,"Albany County, Wyoming",56,001,56001
15002.0,609.0,558.0,60.0,10,7184,6204,1855,1132,1072,60,4349,3253,2984,269,6204,60161,0.4115,41.8,8803,14458,12412,194,279,50,275,1248,"Carbon County, Wyoming",56,007,56007
13225.0,362.0,785.0,23.0,0,5926,5207,1982,1146,1122,24,3225,2624,2450,174,5207,54289,0.4197,39.3,6031,12868,11304,28,79,33,0,1424,"Goshen County, Wyoming",56,015,56015
20116.0,327.0,601.0,5.0,302,9155,7597,2014,1365,1350,15,5583,4313,3963,350,7597,63403,0.3861,40.1,9041,20281,17762,96,152,19,318,1934,"Uinta County, Wyoming",56,041,56041
7946.0,291.0,129.0,11.0,0,3663,3365,1215,734,691,43,2150,1655,1500,155,3365,54158,0.3868,41.0,3860,7870,6643,44,1,10,70,1102,"Washakie County, Wyoming",56,043,56043
4574.0,224.0,96.0,17.0,9,2141,2118,780,498,463,35,1338,943,901,42,2118,51413,0.4149,42.2,2611,4533,3888,3,6,0,0,636,"Hot Springs County, Wyoming",56,017,56017
39275.0,820.0,1081.0,60.0,192,17093,14907,4974,3145,2923,222,9933,7539,6735,804,14907,55896,0.4328,39.9,18010,39199,31473,391,145,24,39,7127,"Fremont County, Wyoming",56,013,56013
9867.0,403.0,398.0,46.0,10,5102,3340,1088,804,791,13,2252,1600,1490,110,3340,77403,0.3964,39.0,6028,9861,8387,51,46,146,187,1044,"Sublette County, Wyoming",56,035,56035
6898.0,270.0,317.0,0.0,300,3135,2891,969,583,583,0,1922,1527,1395,132,2891,57031,0.4119,39.7,3562,6709,5810,24,81,0,0,794,"Weston County, Wyoming",56,045,56045
,,,,0,6804,8592,3286,2207,2124,83,5306,4376,4057,319,8592,20521,0.4769,34.7,9913,22955,22024,52,85,0,77,717,"Aibonito Municipio, Puerto Rico",72,009,72009
,,,,0,11477,12558,4155,2863,2602,261,8403,6784,6278,506,12558,19605,0.5028,35.6,15608,38718,35192,19,84,0,0,3423,"Juncos Municipio, Puerto Rico",72,077,72077
,,,,0,4781,7665,3725,2476,2386,90,3940,2950,2766,184,7665,13992,0.5283,34.0,12244,22789,21612,86,38,26,0,1027,"Lajas Municipio, Puerto Rico",72,079,72079
,,,,0,3814,5771,2224,1576,1499,77,3547,2808,2672,136,5771,14012,0.5028,32.9,7586,17837,16584,7,11,0,22,1213,"Adjuntas Municipio, Puerto Rico",72,001,72001
,,,,17,8692,11394,4202,2664,2626,38,7192,5709,5583,126,11394,17000,0.5307,33.2,14148,31453,29665,146,93,0,45,1504,"Camuy Municipio, Puerto Rico",72,027,72027
,,,,26,7105,8058,2843,1844,1762,82,5215,4009,3646,363,8058,19432,0.4396,35.3,11418,26043,24230,50,34,33,20,1676,"Naguabo Municipio, Puerto Rico",72,103,72103
,,,,34,7216,8424,3526,2161,2161,0,4898,4088,4000,88,8424,18883,0.4886,33.6,10361,28061,26521,24,1,0,34,1481,"Naranjito Municipio, Puerto Rico",72,105,72105
,,,,128,22160,31910,12637,8071,7660,411,19273,14991,14328,663,31910,18647,0.506,34.5,41312,84721,79307,304,236,30,92,4752,"Arecibo Municipio, Puerto Rico",72,013,72013
,,,,30,3486,5908,2128,1325,1306,19,3780,2976,2869,107,5908,17570,0.4681,34.4,8364,17791,17188,5,8,1,12,577,"Arroyo Municipio, Puerto Rico",72,015,72015
,,,,0,6829,8083,3066,1952,1918,34,5017,3975,3733,242,8083,17473,0.5081,33.2,10392,23626,22371,174,57,0,191,833,"Quebradillas Municipio, Puerto Rico",72,115,72115
,,,,66,9668,14022,5183,3258,3145,113,8839,6327,5970,357,14022,17261,0.5098,34.6,18264,38730,36127,114,140,0,9,2340,"Guayama Municipio, Puerto Rico",72,057,72057
,,,,0,591,482,230,100,93,7,252,198,155,43,482,23333,0.4674,37.2,1528,1311,1115,5,29,6,20,136,"Culebra Municipio, Puerto Rico",72,049,72049
,,,,78,17428,14529,4679,3400,3321,79,9850,7792,7385,407,14529,35018,0.5402,37.1,17209,46721,42532,186,272,0,63,3668,"Gurabo Municipio, Puerto Rico",72,063,72063
,,,,11,6259,7989,2890,2014,1890,124,5099,3904,3759,145,7989,17154,0.496,35.7,10042,24069,22827,108,34,0,0,1100,"Barceloneta Municipio, Puerto Rico",72,017,72017
,,,,162,8330,10990,5006,2940,2829,111,5984,4451,4056,395,10990,14743,0.507,33.8,17521,35264,32975,106,26,0,14,2143,"Yauco Municipio, Puerto Rico",72,153,72153
,,,,32,13307,21635,8259,5398,5097,301,13376,10191,9569,622,21635,16269,0.5604,35.6,27278,51556,48549,293,178,12,116,2408,"Aguadilla Municipio, Puerto Rico",72,005,72005
,,,,48,12677,15473,6940,4522,4276,246,8533,6439,5966,473,15473,16708,0.5436,35.1,29578,48363,45582,188,177,0,16,2400,"Cabo Rojo Municipio, Puerto Rico",72,023,72023
,,,,15,3746,6144,2430,1512,1398,114,3714,2786,2565,221,6144,16007,0.5077,36.3,8744,16913,15873,79,30,0,0,931,"Patillas Municipio, Puerto Rico",72,109,72109
,,,,40,6245,7908,2755,1897,1803,94,5153,4366,4070,296,7908,19877,0.5174,33.7,9270,22271,21392,0,43,0,25,811,"Villalba Municipio, Puerto Rico",72,149,72149
,,,,1093,56203,61909,24300,15610,15036,574,37609,27612,25399,2213,61909,29059,0.4901,36.7,77009,153138,132627,4579,3208,707,1334,10683,"Carolina Municipio, Puerto Rico",72,031,72031
,,,,72,13035,16213,6292,4200,4009,191,9921,7916,7428,488,16213,22518,0.5059,35.6,20010,43743,40294,115,166,0,167,3001,"Cayey Municipio, Puerto Rico",72,035,72035
,,,,0,14902,17615,7066,4422,4263,159,10549,8070,7633,437,17615,20434,0.5459,35.2,26487,52157,49276,454,168,20,146,2093,"Humacao Municipio, Puerto Rico",72,069,72069
,,,,95,8672,9645,3111,2232,2124,108,6534,5492,5327,165,9645,20941,0.4506,36.4,11673,30939,28954,206,11,0,10,1758,"Morovis Municipio, Puerto Rico",72,101,72101
,,,,240,26145,23800,8708,6060,5847,213,15092,12031,11348,683,23800,32545,0.4824,37.4,29335,66041,59052,1034,696,49,246,4964,"Trujillo Alto Municipio, Puerto Rico",72,139,72139
,,,,31,10551,14825,5846,4040,3796,244,8979,7081,6788,293,14825,18502,0.5234,35.6,18560,38680,35536,60,55,0,0,3029,"Manatí Municipio, Puerto Rico",72,091,72091
,,,,0,5075,6863,2403,1662,1610,52,4460,3636,3557,79,6863,16718,0.5109,32.9,8705,20362,19698,47,1,0,0,616,"Peñuelas Municipio, Puerto Rico",72,111,72111
,,,,15,4638,5018,2265,1168,1070,98,2753,1951,1860,91,5018,19907,0.4948,33.5,9404,14022,13254,57,130,24,34,523,"Rincón Municipio, Puerto Rico",72,117,72117
,,,,31,7704,11722,5451,3149,3035,114,6271,4735,4414,321,11722,16486,0.5532,33.5,15696,31345,29812,145,34,0,35,1319,"San Germán Municipio, Puerto Rico",72,125,72125
,,,,50,8910,13313,5839,3982,3822,160,7474,6049,5860,189,13313,15331,0.5475,34.9,18010,36991,34721,142,185,0,58,1885,"San Sebastián Municipio, Puerto Rico",72,131,72131
735841.0,18659.0,13404.0,5663.0,10106,358706,301948,89039,50363,47491,2872,212909,155106,134684,20422,301948,60075,0.4639,37.4,327880,736134,651574,35945,24414,1436,2634,20131,"Monroe County, New York",36,055,36055
227344.0,6587.0,2514.0,1059.0,981,100151,89729,29504,16982,16181,801,60225,44417,39908,4509,89729,56027,0.4537,37.7,105267,222440,197691,9450,6436,359,738,7766,"Oneida County, New York",36,065,36065
176997.0,6505.0,1812.0,536.0,2195,85533,69320,24243,14634,13436,1198,45077,33366,29046,4320,69320,64304,0.4592,37.3,85139,174315,153349,7533,4013,480,1468,7472,"Ulster County, New York",36,111,36111
84017.0,2084.0,892.0,159.0,804,36723,33989,10996,6131,5846,285,22993,17293,15425,1868,33989,54940,0.4423,37.9,38870,81599,75746,1301,1069,65,55,3363,"Chemung County, New York",36,015,36015
63110.0,3732.0,522.0,151.0,189,28667,24176,7824,4737,4390,347,16352,12684,11094,1590,24176,59510,0.4238,37.0,27506,61017,57181,872,1022,57,184,1701,"Livingston County, New York",36,051,36051
59493.0,3559.0,833.0,254.0,472,27257,23409,8579,5322,4878,444,14830,11046,9616,1430,23409,54028,0.4465,36.6,31232,59306,54605,1146,697,40,140,2678,"Otsego County, New York",36,077,36077
47100.0,999.0,301.0,174.0,254,19999,17100,6918,3628,3421,207,10182,7585,6783,802,17100,53601,0.4526,37.8,29678,44501,40105,2095,425,61,105,1710,"Greene County, New York",36,039,36039
304197.0,15204.0,4084.0,2250.0,9552,157933,126540,35873,19951,18867,1084,90667,61436,50675,10761,126540,66252,0.46,37.0,141553,303159,262078,18112,13481,491,1254,7743,"Albany County, New York",36,001,36001
46252.0,2084.0,621.0,124.0,70,19545,17948,6145,3658,3402,256,11803,8942,8077,865,17948,48412,0.44,36.8,26373,46221,42093,465,594,41,25,3003,"Allegany County, New York",36,003,36003
76402.0,1737.0,868.0,189.0,128,32891,31779,10263,6033,5668,365,21516,15776,14060,1716,31779,48703,0.4326,37.8,41596,76342,69703,854,509,28,54,5194,"Cattaraugus County, New York",36,009,36009
70618.0,2851.0,1143.0,419.0,120,33349,25877,8593,5152,4769,383,17284,13179,11858,1321,25877,61633,0.4307,37.7,32278,70712,65832,982,807,31,21,3039,"Madison County, New York",36,053,36053
153197.0,5137.0,1977.0,851.0,2833,71932,54302,16830,9923,9242,681,37472,25664,23473,2191,54302,65499,0.4348,37.5,69615,153085,130940,10702,4940,722,748,5033,"Schenectady County, New York",36,093,36093
57136.0,1900.0,394.0,27.0,51,28903,23759,7339,4147,3934,213,16420,12343,10965,1378,23759,60524,0.4117,38.7,25797,57314,54422,501,406,30,140,1815,"Genesee County, New York",36,037,36037
24759.0,929.0,357.0,27.0,35,11252,8919,3374,2055,1928,127,5545,4394,3906,488,8919,56563,0.448,37.9,13870,24685,19871,277,192,11,24,4310,"Yates County, New York",36,123,36123
20790.0,2004.0,296.0,89.0,11,8205,7164,2348,1408,1367,41,4816,3767,3383,384,7164,39837,0.4398,40.3,8331,18673,15240,190,144,93,1008,1998,"Greene County, North Carolina",37,079,37079
14816.0,407.0,92.0,0.0,5,6259,6344,2629,1413,1348,65,3715,2925,2683,242,6344,46103,0.4146,39.3,8831,14897,12860,115,166,21,296,1439,"Mitchell County, North Carolina",37,121,37121
13982.0,277.0,479.0,0.0,26,5460,6133,2448,1343,1332,11,3685,2839,2654,185,6133,46519,0.4389,37.8,7304,13824,12262,259,21,0,44,1238,"Chowan County, North Carolina",37,041,37041
10908.0,125.0,101.0,7.0,17,4536,4920,1921,1295,1259,36,2999,2281,2131,150,4920,37830,0.4494,38.7,8180,10896,9299,225,142,31,230,969,"Alleghany County, North Carolina",37,005,37005
81331.0,3568.0,1787.0,133.0,11,35782,32864,11203,7271,7016,255,21661,16595,15560,1035,32864,44511,0.4345,39.2,38067,81040,69773,751,523,217,1141,8635,"Caldwell County, North Carolina",37,027,37027
155843.0,6366.0,3188.0,430.0,190,72023,62319,19766,12373,11900,473,42553,33080,30188,2892,62319,52056,0.4623,39.2,69024,156051,130848,3739,3292,821,2852,14499,"Catawba County, North Carolina",37,035,37035
96217.0,3100.0,2414.0,51.0,105,39146,35638,12168,7795,7559,236,23470,17769,16553,1216,35638,42247,0.4721,38.6,43614,97038,83595,843,801,207,527,11065,"Cleveland County, North Carolina",37,045,37045
101405.0,3493.0,6061.0,1094.0,129,46415,41226,13572,8707,8278,429,27654,20962,19510,1452,41226,52687,0.4538,40.3,47146,94907,81480,1768,1475,245,1107,8832,"Craven County, North Carolina",37,049,37049
52064.0,1206.0,353.0,88.0,41,20926,21151,7444,4471,4305,166,13707,10749,10103,646,21151,36866,0.4728,38.1,24990,52117,46135,389,207,40,490,4856,"Edgecombe County, North Carolina",37,065,37065
58929.0,3429.0,1004.0,139.0,61,26317,21400,6486,4364,4196,168,14914,11707,10986,721,21400,55856,0.4298,39.7,24318,56456,49860,972,636,114,788,4086,"Granville County, North Carolina",37,077,37077
130482.0,7352.0,5383.0,739.0,86,55740,45416,11094,6902,6679,223,34322,26888,25137,1751,45416,53554,0.4129,40.1,51828,126281,107495,2622,2060,372,2804,10928,"Harnett County, North Carolina",37,085,37085
52725.0,3916.0,1780.0,540.0,111,21455,17799,3453,2151,2046,105,14346,10726,10254,472,17799,48072,0.43,40.8,20880,50096,41580,713,846,214,1217,5526,"Hoke County, North Carolina",37,093,37093
113998.0,4044.0,3362.0,117.0,106,52496,49221,20011,12773,12218,555,29210,21828,19831,1997,49221,55945,0.4372,38.5,57508,113773,95398,2816,2330,467,2730,10032,"Henderson County, North Carolina",37,089,37089
5144.0,403.0,21.0,0.0,7,1876,1947,743,371,349,22,1204,1055,1029,26,1947,39663,0.3824,40.1,3353,4626,3806,0,13,69,133,605,"Hyde County, North Carolina",37,095,37095
173527.0,5549.0,5589.0,735.0,252,84350,66369,19163,12988,12659,329,47206,37627,34788,2839,66369,60955,0.47,39.4,74184,174408,150687,3763,4347,521,2690,12400,"Iredell County, North Carolina",37,097,37097
1060540.0,25705.0,45437.0,9422.0,16204,559130,411097,82126,50808,48611,2197,328971,231963,202741,29222,411097,66641,0.4865,39.8,445287,1069233,833193,52196,59634,7502,45461,71247,"Mecklenburg County, North Carolina",37,119,37119
19791.0,1115.0,283.0,0.0,10,7088,8547,3544,2214,2027,187,5003,3826,3583,243,8547,37146,0.4667,40.0,11666,19111,16328,78,84,3,126,2492,"Northampton County, North Carolina",37,131,37131
176475.0,14393.0,6583.0,409.0,1048,83463,69799,16363,10162,9756,406,53436,38811,31359,7452,69799,47437,0.4874,37.8,79384,177203,153488,2995,2755,468,2300,15197,"Pitt County, North Carolina",37,147,37147
138785.0,6672.0,2626.0,479.0,191,61222,52843,16901,10726,10368,358,35942,28012,25476,2536,52843,49842,0.4452,38.8,61642,137980,118561,1342,1737,455,2946,12939,"Rowan County, North Carolina",37,159,37159
43895.0,2034.0,376.0,237.0,13,18187,16875,5508,3511,3379,132,11367,8554,7784,770,16875,40529,0.488,38.4,20139,44052,37872,358,1075,154,730,3863,"Vance County, North Carolina",37,181,37181
27792.0,591.0,1333.0,28.0,19,10640,12471,5728,3922,3756,166,6743,5223,4709,514,12471,41438,0.4151,38.6,18258,27657,23158,362,219,48,122,3748,"Cherokee County, North Carolina",37,039,37039
25974.0,308.0,1388.0,65.0,5,12776,10522,3021,2150,2052,98,7501,6188,5415,773,10522,69964,0.3841,40.2,15806,25929,22095,248,136,66,55,3329,"Currituck County, North Carolina",37,053,37053
228838.0,8494.0,6570.0,493.0,512,111820,76346,19137,14115,13710,405,57209,49909,47467,2442,76346,80033,0.4532,39.0,81056,229942,194078,9106,5962,1289,5614,13893,"Union County, North Carolina",37,179,37179
67777.0,1151.0,485.0,130.0,42,29088,28753,10236,6139,5948,191,18517,14216,12961,1255,28753,44107,0.4669,39.6,33587,67621,58402,781,736,152,1158,6392,"Wilkes County, North Carolina",37,193,37193
92858.0,5935.0,1812.0,454.0,215,42114,37011,12120,7444,7063,381,24891,18840,17659,1181,37011,49537,0.4673,39.0,43045,92736,81251,1272,1212,232,1157,7612,"Nash County, North Carolina",37,127,37127
36821.0,1855.0,409.0,27.0,0,16401,14169,5069,3282,3170,112,9100,7422,7062,360,14169,48756,0.4661,39.8,16465,35908,31924,420,379,0,416,2769,"Alexander County, North Carolina",37,003,37003
35944.0,722.0,1388.0,221.0,9,18016,15529,5347,3564,3392,172,10182,7666,6889,777,15529,59381,0.4317,39.5,34745,36022,30020,688,557,44,592,4121,"Dare County, North Carolina",37,055,37055
19582.0,971.0,307.0,23.0,11,7068,7786,3384,1935,1845,90,4402,2909,2744,165,7786,36466,0.4987,38.5,12002,19012,16293,217,93,4,228,2177,"Warren County, North Carolina",37,185,37185
80668.0,2158.0,845.0,344.0,63,34858,32014,10182,5671,5280,391,21832,16239,15085,1154,32014,43877,0.4679,38.8,36146,80405,67775,1818,1030,197,2105,7480,"Wilson County, North Carolina",37,195,37195
11445.0,90.0,464.0,2.0,0,5143,4638,1666,1103,1095,8,2972,2273,2110,163,4638,50750,0.4064,40.1,5380,11493,10671,56,10,0,20,736,"Gates County, North Carolina",37,073,37073
8476.0,98.0,179.0,2.0,2,3340,3393,1323,808,790,18,2070,1517,1388,129,3393,39571,0.4322,37.3,6050,8402,6983,12,12,0,85,1310,"Graham County, North Carolina",37,075,37075
21352.0,1122.0,593.0,49.0,0,8943,8403,3235,1910,1818,92,5168,4126,3638,488,8403,45873,0.464,37.7,10972,21263,18929,160,192,10,45,1927,"Madison County, North Carolina",37,115,37115
12655.0,534.0,173.0,20.0,19,4684,5416,2557,1674,1616,58,2859,2072,1973,99,5416,46728,0.4823,37.9,7734,11977,10536,150,48,0,111,1132,"Pamlico County, North Carolina",37,137,37137
20433.0,767.0,664.0,12.0,9,8153,9071,4261,2585,2474,111,4810,3411,3076,335,9071,48787,0.4468,38.4,11719,20272,17608,328,283,33,178,1842,"Polk County, North Carolina",37,149,37149
141468.0,5371.0,1767.0,123.0,206,64346,56541,17525,10855,10547,308,39016,30370,27984,2386,56541,47288,0.4284,39.6,62411,141792,117681,2030,2660,276,3885,15260,"Randolph County, North Carolina",37,151,37151
45444.0,1449.0,263.0,35.0,23,20804,19578,6531,4051,3942,109,13047,10052,9406,646,19578,48054,0.4239,39.5,22245,45305,39930,192,108,56,418,4601,"Stokes County, North Carolina",37,169,37169
11724.0,339.0,264.0,17.0,0,4309,4977,2054,1061,1022,39,2923,1822,1633,189,4977,35979,0.5099,38.2,6458,11759,10291,42,20,0,128,1278,"Washington County, North Carolina",37,187,37187
10868.0,106.0,410.0,0.0,0,4171,4996,2253,1448,1423,25,2743,2131,2001,130,4996,42222,0.4813,38.7,7351,10922,9288,120,42,0,120,1352,"Clay County, North Carolina",37,043,37043
327529.0,8555.0,24614.0,3832.0,728,153083,125427,28377,16735,16133,602,97050,67275,62052,5223,125427,46875,0.4465,40.4,146328,301989,256323,9566,6076,985,2728,26311,"Cumberland County, North Carolina",37,051,37051
521743.0,18486.0,14114.0,2929.0,2988,248015,203987,54692,33624,31990,1634,149295,109363,97256,12107,203987,53261,0.4848,38.5,228346,523811,433362,20957,19564,2788,11009,36131,"Guilford County, North Carolina",37,081,37081
42588.0,3484.0,1340.0,222.0,46,18452,16773,5805,3556,3325,231,10968,8199,6639,1560,16773,47252,0.4462,35.5,27297,42722,36501,244,390,20,877,4690,"Jackson County, North Carolina",37,099,37099
38885.0,2148.0,1751.0,21.0,25,16903,14697,4560,2727,2635,92,10137,7656,7194,462,14697,50558,0.4268,38.3,17157,37957,32596,557,269,191,370,3974,"Pasquotank County, North Carolina",37,139,37139
130936.0,2623.0,877.0,132.0,110,47986,45927,14061,8638,8216,422,31866,23859,22492,1367,45927,34976,0.4882,38.6,53210,130886,110161,1050,1194,396,2835,15250,"Robeson County, North Carolina",37,155,37155
14047.0,440.0,534.0,32.0,41,5495,5620,1904,1158,1103,55,3716,2611,2512,99,5620,39317,0.4694,38.0,9022,14079,10853,112,88,38,157,2831,"Swain County, North Carolina",37,173,37173
1057046.0,36999.0,36100.0,8473.0,5809,557427,400172,83359,53962,51859,2103,316813,243783,216183,27600,400172,80591,0.4441,39.3,431552,1061002,863012,57052,51634,5222,30369,53713,"Wake County, North Carolina",37,183,37183
24755.0,1222.0,321.0,117.0,0,10224,9521,3211,1732,1652,80,6310,4660,4157,503,9521,40213,0.4428,39.8,11622,23128,20208,199,161,83,197,2280,"Anson County, North Carolina",37,007,37007
44867.0,1361.0,468.0,62.0,6,18248,18173,6204,4219,4074,145,11969,9587,8991,596,18173,43646,0.4423,39.0,21403,44328,38228,520,467,65,732,4316,"McDowell County, North Carolina",37,111,37111
65651.0,3988.0,1138.0,151.0,59,30171,25381,7450,5065,4921,144,17931,14438,13498,940,25381,55193,0.4155,39.6,28507,65468,57024,1126,863,81,1636,4738,"Franklin County, North Carolina",37,069,37069
9526.0,534.0,157.0,11.0,2,3630,4045,1644,992,930,62,2401,1839,1714,125,4045,38158,0.4658,38.8,4985,9527,7928,81,16,0,134,1368,"Jones County, North Carolina",37,103,37103
34538.0,423.0,1961.0,68.0,32,13826,15921,7002,4364,4155,209,8919,6799,6095,704,15921,45507,0.4675,37.9,25608,34625,29228,551,244,63,1034,3505,"Macon County, North Carolina",37,113,37113
130777.0,6122.0,5334.0,150.0,202,51753,56056,25590,18688,17929,759,30466,22311,20358,1953,56056,58236,0.4478,37.9,89368,130804,114281,2640,1094,309,1056,11424,"Brunswick County, North Carolina",37,019,37019
33468.0,976.0,1025.0,204.0,24,13556,14567,6778,4614,4424,190,7789,6070,5554,516,14567,50212,0.4426,36.5,19645,33285,28285,327,182,12,444,4035,"Transylvania County, North Carolina",37,175,37175
46534.0,636.0,454.0,54.0,20,19213,19701,7789,4511,4398,113,11912,9090,8240,850,19701,45212,0.4826,38.1,26081,46791,40303,389,466,88,711,4834,"Beaufort County, North Carolina",37,013,37013
55462.0,2310.0,1221.0,80.0,41,19355,21580,7939,4542,4442,100,13641,10272,9801,471,21580,37628,0.5036,39.3,26332,53109,45590,374,458,87,508,6092,"Columbus County, North Carolina",37,047,37047
82201.0,3432.0,1697.0,127.0,87,39222,32894,10092,6866,6489,377,22802,18575,17183,1392,32894,57536,0.4576,39.8,35916,82293,72110,1930,1019,67,839,6328,"Lincoln County, North Carolina",37,109,37109
26864.0,1110.0,81.0,42.0,22,10711,10195,3831,2306,2244,62,6364,4816,4544,272,10195,44146,0.4872,39.6,16258,26174,21328,552,836,58,854,2546,"Montgomery County, North Carolina",37,123,37123
143767.0,11195.0,6799.0,2429.0,5123,72611,53376,13793,8739,8195,544,39583,28784,23799,4985,53376,71723,0.5186,36.2,58256,144191,118633,8139,7330,481,3116,6492,"Orange County, North Carolina",37,135,37135
44575.0,1322.0,657.0,64.0,81,17588,18380,5891,3287,3176,111,12489,9395,8607,788,18380,36148,0.4655,39.0,21585,43619,37692,547,287,106,706,4281,"Richmond County, North Carolina",37,153,37153
62658.0,2737.0,421.0,446.0,90,26619,23416,7857,4621,4582,39,15559,11850,11123,727,23416,42151,0.4685,40.1,27726,62713,50021,959,1871,282,3187,6393,"Sampson County, North Carolina",37,163,37163
71276.0,1275.0,952.0,162.0,86,30747,29153,10177,5987,5875,112,18976,14780,13980,800,29153,43597,0.4845,39.4,34160,71158,60587,937,952,308,1625,6749,"Surry County, North Carolina",37,171,37171
17322.0,1490.0,380.0,12.0,34,6370,6551,2615,1736,1718,18,3936,2882,2601,281,6551,40340,0.4794,37.3,14225,14884,12301,95,126,51,211,2100,"Avery County, North Carolina",37,011,37011
254861.0,6824.0,8075.0,1265.0,778,125207,107479,34646,20340,19035,1305,72833,51255,43572,7683,107479,52207,0.4697,37.9,123642,253150,216231,5596,4340,1213,4717,21053,"Buncombe County, North Carolina",37,021,37021
204344.0,9533.0,5284.0,350.0,870,101526,72238,18074,12084,11665,419,54164,44109,41438,2671,72238,67328,0.4346,39.0,79437,205208,176000,7086,6375,446,3405,11896,"Cabarrus County, North Carolina",37,025,37025
22511.0,661.0,266.0,22.0,0,9408,9145,3306,2208,2086,122,5839,4684,4484,200,9145,45733,0.4342,38.5,10823,21730,19764,227,137,22,206,1374,"Caswell County, North Carolina",37,033,37033
41975.0,2062.0,940.0,88.0,41,19024,16405,5992,3701,3526,175,10413,8665,8060,605,16405,60434,0.4395,39.1,18753,41936,36703,605,591,160,706,3171,"Davie County, North Carolina",37,059,37059
163592.0,5917.0,3028.0,202.0,307,73521,66653,21151,13644,13164,480,45502,36106,32991,3115,66653,49546,0.4342,39.7,74839,163689,140522,2321,2274,520,2966,15086,"Davidson County, North Carolina",37,057,37057
57867.0,1955.0,682.0,237.0,18,24118,21466,7510,4542,4349,193,13956,10991,10155,836,21466,41764,0.4248,39.7,25958,58571,45590,831,2159,425,3753,5813,"Duplin County, North Carolina",37,061,37061
307452.0,12189.0,13677.0,3811.0,5145,159599,125953,27958,17152,16476,676,97995,66974,56306,10668,125953,60958,0.4681,39.1,136060,306362,242057,13254,14403,1525,14653,20470,"Durham County, North Carolina",37,063,37063
23755.0,1190.0,984.0,28.0,27,9314,8845,3265,1788,1699,89,5580,4004,3720,284,8845,41028,0.4338,37.7,10660,22534,19586,253,130,35,148,2382,"Hertford County, North Carolina",37,091,37091
59920.0,2058.0,936.0,502.0,140,26409,21894,6872,4391,4213,178,15022,11779,11010,769,21894,49994,0.4428,39.0,24509,59339,47967,1593,1549,375,2196,5659,"Lee County, North Carolina",37,105,37105
225354.0,11407.0,7148.0,779.0,598,109786,95638,27601,16231,15343,888,68037,47394,38768,8626,95638,54891,0.491,37.6,111031,225237,194640,5441,2950,884,2789,18533,"New Hanover County, North Carolina",37,129,37129
59702.0,4132.0,918.0,51.0,118,26143,21740,7282,4810,4663,147,14458,10723,10013,710,21740,57240,0.465,38.3,29030,58921,51672,725,500,48,1008,4968,"Pender County, North Carolina",37,141,37141
121837.0,4157.0,3487.0,1033.0,258,53988,48343,14781,8833,8509,324,33562,25798,23602,2196,48343,44416,0.4753,39.7,54291,119247,99628,1906,2677,235,4259,10542,"Wayne County, North Carolina",37,191,37191
34662.0,1636.0,514.0,49.0,27,11704,12922,4384,2612,2529,83,8538,6449,6064,385,12922,37238,0.467,37.7,15312,33249,29028,235,171,83,222,3510,"Scotland County, North Carolina",37,165,37165
54628.0,6288.0,1717.0,94.0,437,25148,21077,5824,3888,3674,214,15253,11384,7778,3606,21077,47526,0.5043,34.3,33751,54623,48447,655,559,50,347,4565,"Watauga County, North Carolina",37,189,37189
50856.0,1387.0,443.0,34.0,11,18597,21017,7766,4621,4427,194,13251,9843,9253,590,21017,35502,0.4969,39.1,25939,49917,43081,374,282,54,230,5896,"Halifax County, North Carolina",37,083,37083
161481.0,6182.0,3263.0,633.0,139,76425,64439,19637,11531,10996,535,44802,33953,30759,3194,64439,49688,0.4533,38.8,70644,162195,136679,3640,3699,613,4877,12687,"Alamance County, North Carolina",37,001,37001
4062.0,430.0,36.0,0.0,6,1495,1594,606,382,359,23,988,724,676,48,1594,35300,0.425,40.0,2119,3356,2873,0,35,9,84,355,"Tyrrell County, North Carolina",37,177,37177
30444.0,888.0,1964.0,369.0,196,15837,12524,2667,1541,1459,82,9857,6920,5983,937,12524,72045,0.4533,43.6,14706,30776,27308,309,398,26,205,2530,"Stark County, North Dakota",38,089,38089
3889.0,164.0,20.0,0.0,0,1852,1943,771,403,384,19,1172,811,748,63,1943,57582,0.4368,42.3,2422,3888,3739,9,4,0,0,136,"Wells County, North Dakota",38,103,38103
2163.0,42.0,39.0,0.0,0,1042,905,275,147,142,5,630,452,427,25,905,77232,0.4204,45.0,1405,2179,2018,23,21,0,6,111,"Burke County, North Dakota",38,013,38013
10131.0,441.0,292.0,31.0,38,4669,3360,814,544,518,26,2546,1786,1660,126,3360,72147,0.47,43.0,5205,10258,8229,122,163,5,19,1720,"Mountrail County, North Dakota",38,061,38061
34684.0,1470.0,2666.0,225.0,48,18476,14320,2362,1256,1222,34,11958,8683,7437,1246,14320,87161,0.4329,46.0,19322,34869,28590,602,860,215,444,4158,"Williams County, North Dakota",38,105,38105
917.0,11.0,6.0,0.0,7,439,383,145,81,81,0,238,203,190,13,383,75208,0.4213,41.1,543,922,885,0,10,4,0,23,"Billings County, North Dakota",38,007,38007
2439.0,68.0,208.0,10.0,6,1137,1092,360,232,228,4,732,553,520,33,1092,54643,0.4577,43.2,1678,2463,2120,27,10,0,0,306,"Kidder County, North Dakota",38,043,38043
3773.0,105.0,100.0,12.0,0,1844,1737,634,382,377,5,1103,842,740,102,1737,64798,0.4922,42.8,2320,3696,3467,16,28,0,4,181,"Cavalier County, North Dakota",38,019,38019
2334.0,138.0,110.0,4.0,0,1064,1074,453,245,235,10,621,442,406,36,1074,50938,0.5088,47.2,1710,2295,2142,14,19,0,0,120,"Grant County, North Dakota",38,037,38037
5791.0,212.0,89.0,7.0,7,2827,2594,846,494,467,27,1748,1350,1244,106,2594,64179,0.4682,42.9,3171,5799,5470,44,22,0,6,257,"McHenry County, North Dakota",38,049,38049
1717.0,55.0,8.0,0.0,2,915,777,266,162,155,7,511,357,339,18,777,70724,0.3728,45.5,1141,1744,1637,20,0,3,0,84,"Steele County, North Dakota",38,091,38091
6715.0,221.0,32.0,11.0,9,2322,2248,654,475,460,15,1594,1234,1143,91,2248,47667,0.5035,40.3,3059,6863,6089,10,8,4,2,750,"Benson County, North Dakota",38,005,38005
4093.0,96.0,88.0,10.0,0,2005,1822,697,451,422,29,1125,828,744,84,1822,60806,0.4713,43.1,2256,4051,3842,34,18,0,13,144,"LaMoure County, North Dakota",38,045,38045
30383.0,1901.0,486.0,105.0,2,17848,13565,3278,2029,1896,133,10287,8086,6778,1308,13565,70556,0.4432,41.2,15002,30273,28191,380,103,0,75,1524,"Morton County, North Dakota",38,059,38059
4344.0,146.0,202.0,37.0,8,2028,1692,499,282,278,4,1193,892,837,55,1692,76719,0.4743,43.8,2621,4337,3440,32,51,4,12,798,"Dunn County, North Dakota",38,025,38025
2591.0,89.0,96.0,4.0,2,1397,1291,487,275,262,13,804,555,489,66,1291,52587,0.4457,45.2,1853,2488,2297,24,19,30,13,105,"McIntosh County, North Dakota",38,051,38051
2848.0,113.0,73.0,18.0,3,1429,1467,557,288,275,13,910,589,538,51,1467,52039,0.462,42.4,1941,2824,2590,25,6,0,52,151,"Nelson County, North Dakota",38,063,38063
14267.0,349.0,92.0,3.0,3,5214,4608,1218,714,619,95,3390,2716,2548,168,4608,43158,0.5003,39.4,5582,14396,10723,19,26,11,0,3617,"Rolette County, North Dakota",38,079,38079
10612.0,291.0,193.0,9.0,7,5277,4780,1498,860,813,47,3282,2348,2135,213,4780,55700,0.4619,41.3,5610,10570,9694,154,167,19,71,465,"Walsh County, North Dakota",38,099,38099
6435.0,361.0,240.0,25.0,1,3117,2992,1026,586,574,12,1966,1420,1258,162,2992,60381,0.441,41.5,4432,6365,6014,59,67,0,4,221,"Bottineau County, North Dakota",38,009,38009
10583.0,331.0,369.0,5.0,28,5714,5074,1585,889,884,5,3489,2368,2024,344,5074,58365,0.4671,39.4,5961,10511,9651,46,171,0,6,637,"Barnes County, North Dakota",38,003,38003
69394.0,2303.0,5980.0,520.0,388,38404,30502,6036,3214,3072,142,24466,16887,13097,3790,30502,54051,0.4716,37.4,32961,68233,60420,1439,2057,33,333,3951,"Grand Forks County, North Dakota",38,035,38035
13071.0,424.0,1152.0,0.0,20,6547,4302,796,447,405,42,3506,2689,2213,476,4302,77845,0.4667,45.2,6643,13212,10863,295,35,17,5,1997,"McKenzie County, North Dakota",38,053,38053
9495.0,541.0,64.0,6.0,0,4496,4334,1479,911,872,39,2855,2149,2020,129,4334,68529,0.4077,41.7,6203,9429,8821,54,52,3,9,490,"McLean County, North Dakota",38,055,38055
4086.0,358.0,68.0,16.0,0,1951,1908,676,293,280,13,1232,952,802,150,1908,55660,0.4477,41.7,2268,3960,3818,8,11,0,0,123,"Pierce County, North Dakota",38,069,38069
2392.0,137.0,29.0,0.0,6,1175,950,285,175,168,7,665,513,460,53,950,73182,0.3508,43.1,1327,2372,2210,68,11,0,0,83,"Renville County, North Dakota",38,075,38075
3081.0,85.0,45.0,2.0,6,1577,1350,414,234,229,5,936,716,641,75,1350,62442,0.4332,42.7,1775,3080,2890,11,20,0,0,159,"Bowman County, North Dakota",38,011,38011
93301.0,3759.0,1958.0,378.0,137,50372,39507,10192,5675,5458,217,29315,21589,19127,2462,39507,71524,0.4381,39.7,42574,92801,85942,840,969,137,274,4639,"Burleigh County, North Dakota",38,015,38015
1837.0,35.0,34.0,0.0,6,927,849,320,199,188,11,529,371,337,34,849,59375,0.4238,45.9,1174,1796,1735,9,10,0,0,42,"Logan County, North Dakota",38,047,38047
1836.0,134.0,0.0,3.0,0,800,738,285,204,202,2,453,383,381,2,738,78929,0.4064,43.5,992,1837,1686,21,0,0,0,130,"Oliver County, North Dakota",38,065,38065
20721.0,843.0,884.0,166.0,18,10501,8908,2711,1556,1461,95,6197,4061,3569,492,8908,57674,0.4496,39.6,10245,20070,18182,103,222,0,58,1505,"Stutsman County, North Dakota",38,093,38093
11491.0,573.0,225.0,150.0,109,6151,4828,1397,798,761,37,3431,2275,1985,290,4828,58910,0.4775,40.9,5852,11155,10304,44,184,1,6,616,"Ramsey County, North Dakota",38,071,38071
3220.0,128.0,48.0,7.0,6,1739,1423,468,253,248,5,955,663,608,55,1423,61425,0.4066,41.6,1821,3166,2997,0,27,0,0,142,"Foster County, North Dakota",38,031,38031
2375.0,95.0,13.0,0.0,2,1146,1089,455,252,250,2,634,432,421,11,1089,53565,0.4489,41.0,1511,2312,2227,32,0,0,0,53,"Griggs County, North Dakota",38,039,38039
1390.0,110.0,12.0,0.0,0,553,731,300,167,162,5,431,277,254,23,731,51055,0.4218,46.4,894,1409,1317,4,5,0,0,83,"Sheridan County, North Dakota",38,083,38083
742.0,2.0,0.0,0.0,0,316,326,137,88,84,4,189,149,148,1,326,63611,0.3988,44.6,477,742,735,0,2,0,0,5,"Slope County, North Dakota",38,087,38087
55920.0,4771.0,722.0,187.0,237,28343,20212,4769,3216,3093,123,15443,13068,12051,1017,20212,86715,0.4032,39.5,21258,53550,48810,1224,1207,13,33,2263,"Union County, Ohio",39,159,39159
27684.0,1207.0,211.0,1.0,35,10331,10959,3429,2017,1935,82,7530,5883,5477,406,10959,42832,0.4694,38.6,12845,27712,25642,29,65,0,0,1976,"Pike County, Ohio",39,131,39131
18633.0,780.0,208.0,17.0,0,8455,7705,2395,1480,1413,67,5310,4271,4019,252,7705,55330,0.4231,38.6,8759,18711,17427,160,48,3,105,968,"Paulding County, Ohio",39,125,39125
803464.0,22483.0,20593.0,3978.0,13950,399281,341873,88635,48803,46560,2243,253238,173889,150584,23305,341873,57212,0.5009,38.1,379402,805577,723116,19719,17117,1829,7894,35902,"Hamilton County, Ohio",39,061,39061
1272061.0,37852.0,26768.0,9703.0,15789,664580,511447,109682,64429,60904,3525,401765,282767,239079,43688,511447,61305,0.4653,38.5,555090,1282411,1072918,57235,54744,7332,20873,69309,"Franklin County, Ohio",39,049,39049
64617.0,3400.0,733.0,35.0,258,26011,24737,7987,4807,4538,269,16750,12431,11306,1125,24737,47498,0.4524,38.9,27888,59823,55918,391,204,81,274,2955,"Marion County, Ohio",39,101,39101
90888.0,3209.0,907.0,227.0,50,43409,36631,12332,7238,6898,340,24299,19210,17475,1735,36631,53243,0.4185,39.5,40217,91366,83208,545,490,36,535,6552,"Tuscarawas County, Ohio",39,157,39157
114727.0,4147.0,1136.0,175.0,136,54851,43824,14116,8686,8421,265,29708,23093,21612,1481,43824,58300,0.4233,39.0,46648,114966,97862,1121,1039,87,180,14677,"Wayne County, Ohio",39,169,39169
43002.0,1762.0,485.0,69.0,22,19366,17829,5387,3356,3227,129,12442,9832,9109,723,17829,54575,0.4099,39.4,20205,43017,39454,84,109,0,22,3348,"Brown County, Ohio",39,015,39015
375699.0,17101.0,9039.0,2184.0,957,180451,139113,37559,23999,23196,803,101554,79963,72000,7963,139113,66117,0.4416,37.9,151887,376452,336747,10236,8409,523,3917,16620,"Butler County, Ohio",39,017,39017
15067.0,339.0,137.0,17.0,2,6025,6223,2133,1320,1246,74,4090,3123,2964,159,6223,49689,0.4172,40.2,8089,14944,13428,21,66,22,0,1407,"Harrison County, Ohio",39,067,39067
60803.0,2380.0,1541.0,135.0,202,28111,23248,7085,4434,4191,243,16163,12977,11811,1166,23248,57749,0.3951,37.2,25820,60831,54331,309,335,50,103,5703,"Knox County, Ohio",39,083,39083
171314.0,8050.0,2392.0,189.0,179,82299,64035,19294,12282,11741,541,44741,36687,33354,3333,64035,64589,0.4353,38.6,70821,172408,157614,2358,1392,608,187,10249,"Licking County, Ohio",39,089,39089
120184.0,5513.0,1500.0,132.0,485,51512,48449,16468,9738,9270,468,31981,23934,21675,2259,48449,49547,0.4284,38.3,54190,114386,104671,1083,680,64,95,7793,"Richland County, Ohio",39,139,39139
13001.0,452.0,85.0,19.0,26,5274,5140,1693,1028,1000,28,3447,2667,2456,211,5140,45673,0.4048,38.8,6278,13002,11800,54,25,0,0,1123,"Vinton County, Ohio",39,163,39163
27098.0,857.0,313.0,1.0,2,12156,11298,3900,2453,2297,156,7398,5801,5334,467,11298,55267,0.4287,39.1,13607,27050,24649,117,8,3,12,2261,"Carroll County, Ohio",39,019,39019
74886.0,3226.0,1588.0,334.0,137,37800,31937,8681,5031,4823,208,23256,17427,15118,2309,31937,58450,0.4399,38.7,34199,74933,69419,1137,1268,24,350,2735,"Hancock County, Ohio",39,063,39063
201904.0,8126.0,3405.0,323.0,344,101488,78009,22297,14369,13860,509,55712,44297,40621,3676,78009,66968,0.4401,38.8,83205,202956,188576,2152,1962,139,299,9828,"Clermont County, Ohio",39,025,39025
152656.0,8240.0,2600.0,303.0,285,72876,56339,16454,10420,10177,243,39885,32748,30168,2580,56339,67609,0.4206,38.8,61093,151573,138843,3055,1635,297,692,7051,"Fairfield County, Ohio",39,045,39045
37726.0,1320.0,517.0,29.0,53,18502,15297,4731,3063,2953,110,10566,8540,7729,811,15297,59931,0.4036,39.4,16817,37869,35033,401,338,16,99,1982,"Defiance County, Ohio",39,039,39039
42467.0,2218.0,279.0,34.0,38,17205,16772,5475,3270,3060,210,11297,8926,8161,765,16772,44169,0.4423,39.1,19351,42552,38524,284,127,9,19,3589,"Highland County, Ohio",39,071,39071
26983.0,1225.0,298.0,42.0,62,13179,10992,3380,2124,2063,61,7612,6052,5602,450,10992,59695,0.3721,39.9,12089,26771,25329,234,150,11,26,1021,"Henry County, Ohio",39,069,39069
65955.0,1588.0,2055.0,73.0,131,27297,27428,9950,5830,5557,273,17478,12899,11614,1285,27428,46581,0.4602,38.9,32510,65614,61078,554,284,59,59,3580,"Jefferson County, Ohio",39,081,39081
161200.0,9535.0,2426.0,912.0,466,80212,61817,18002,11406,10791,615,43815,32715,28725,3990,61817,57618,0.4501,37.1,69138,161441,147842,1998,3357,135,752,7357,"Portage County, Ohio",39,133,39133
33449.0,1089.0,45.0,37.0,48,17232,13327,3790,2385,2306,79,9537,7987,7457,530,13327,64822,0.3961,39.3,13936,33646,32373,180,82,40,183,788,"Putnam County, Ohio",39,137,39137
67418.0,1743.0,948.0,24.0,145,28565,25919,9350,5220,4955,265,16569,12143,11366,777,25919,50904,0.453,37.2,32210,64197,60001,506,173,48,14,3455,"Belmont County, Ohio",39,013,39013
41417.0,2284.0,513.0,17.0,77,19115,16528,5060,3028,2904,124,11468,8945,8204,741,16528,52815,0.4288,38.8,18163,41626,38741,265,272,19,71,2258,"Clinton County, Ohio",39,027,39027
28200.0,975.0,201.0,163.0,73,12435,11773,3474,2099,2020,79,8299,6566,6050,516,11773,47308,0.4387,39.3,12783,28292,25950,181,150,0,185,1826,"Fayette County, Ohio",39,047,39047
35701.0,1875.0,193.0,57.0,76,14645,13500,3919,2728,2483,245,9581,7872,7156,716,13500,50150,0.4298,39.2,15335,35777,33773,164,52,0,8,1780,"Perry County, Ohio",39,127,39127
57069.0,4744.0,523.0,78.0,31,24314,19710,5947,3856,3679,177,13763,11385,10573,812,19710,63633,0.4096,39.8,21433,53404,49721,544,83,0,127,2929,"Pickaway County, Ohio",39,129,39129
43739.0,3978.0,547.0,98.0,81,18778,15013,4638,2934,2614,320,10375,8623,7800,823,15013,68022,0.4037,39.1,16100,38883,35825,97,344,28,121,2468,"Madison County, Ohio",39,097,39097
85133.0,2907.0,488.0,165.0,95,37647,33878,10721,6106,5856,250,23157,17693,16204,1489,33878,47254,0.4525,38.5,37940,85284,80208,308,361,7,78,4322,"Muskingum County, Ohio",39,119,39119
58361.0,1490.0,533.0,106.0,129,27835,23574,7387,4453,4219,234,16187,12614,11424,1190,23574,54089,0.4041,38.8,26318,58105,54818,473,142,34,246,2392,"Sandusky County, Ohio",39,143,39143
27995.0,885.0,396.0,38.0,28,13490,11544,3594,2205,2122,83,7950,6360,6037,323,11544,54254,0.4058,39.0,12707,27993,26683,45,32,4,59,1170,"Van Wert County, Ohio",39,161,39161
59830.0,987.0,1700.0,119.0,138,26670,25197,8725,5327,5154,173,16472,12262,11243,1019,25197,50021,0.4578,38.6,28218,59750,54792,293,353,11,121,4180,"Washington County, Ohio",39,167,39167
45029.0,2056.0,332.0,14.0,78,23216,18888,5725,3392,3258,134,13163,10572,9828,744,18888,64074,0.3962,39.9,19902,45184,43201,198,148,4,33,1600,"Auglaize County, Ohio",39,011,39011
50890.0,1276.0,663.0,88.0,114,24592,20861,6840,4048,3818,230,14021,11403,10518,885,20861,55620,0.4106,39.4,22903,50918,47687,269,83,36,84,2759,"Darke County, Ohio",39,037,39037
40302.0,1371.0,554.0,18.0,170,18861,18051,6999,4261,4083,178,11052,8610,7829,781,18051,59099,0.4321,39.5,28479,40182,38118,298,103,31,29,1603,"Ottawa County, Ohio",39,123,39123
31020.0,1515.0,642.0,71.0,0,13947,11678,3530,2163,2071,92,8148,6441,5777,664,11678,50506,0.4029,37.6,13194,31239,27440,68,418,14,58,3241,"Hardin County, Ohio",39,065,39065
32129.0,1016.0,328.0,75.0,38,13156,12780,3803,2408,2357,51,8977,7188,6854,334,12780,47550,0.4255,38.8,14852,32115,29217,120,136,0,0,2642,"Jackson County, Ohio",39,079,39079
57726.0,1724.0,832.0,45.0,92,27054,22935,6991,4098,3877,221,15944,12658,11421,1237,22935,52560,0.4093,39.3,25307,57776,52935,359,414,60,97,3911,"Huron County, Ohio",39,077,39077
65499.0,9336.0,2185.0,458.0,297,27769,22557,5817,3523,3349,174,16740,11990,9041,2949,22557,40905,0.5025,33.2,26689,65217,58713,729,1769,17,372,3617,"Athens County, Ohio",39,009,39009
27606.0,464.0,179.0,38.0,109,10251,10673,3505,2017,1932,85,7168,5894,5479,415,10673,39079,0.4815,38.7,12937,27497,25283,74,50,8,0,2082,"Adams County, Ohio",39,001,39001
176238.0,6979.0,2058.0,199.0,289,91857,69007,21374,13283,12937,346,47633,38083,35678,2405,69007,76600,0.4137,38.7,72430,176768,164960,3574,1250,62,168,6754,"Medina County, Ohio",39,103,39103
425447.0,9475.0,9211.0,1264.0,3430,196017,179930,49319,27936,26451,1485,130611,91668,80662,11006,179930,48736,0.4871,38.2,203330,426306,387179,7850,5857,477,1702,23241,"Lucas County, Ohio",39,095,39095
14319.0,1071.0,143.0,1.0,26,3937,5067,2547,1433,1391,42,2520,1983,1789,194,5067,46897,0.4579,32.0,6160,12071,11316,9,0,0,0,746,"Noble County, Ohio",39,121,39121
,,,,1891,63415,67476,26184,17276,16505,771,41292,31699,29740,1959,67476,26420,0.4931,35.5,83204,173096,154899,2867,2341,212,898,11879,"Bayamón Municipio, Puerto Rico",72,021,72021
,,,,128,13780,14643,4983,3413,3300,113,9660,7612,7097,515,14643,21267,0.5458,35.8,17694,45414,39566,472,655,60,683,3978,"Canóvanas Municipio, Puerto Rico",72,029,72029
,,,,59,4853,5565,2466,1454,1422,32,3099,2525,2337,188,5565,13733,0.5113,35.4,7328,19213,18193,24,79,35,0,882,"Comerío Municipio, Puerto Rico",72,045,72045
,,,,25,13778,15408,5491,3924,3820,104,9917,8158,7637,521,15408,20657,0.5044,33.1,18644,45976,43472,39,113,27,24,2301,"Juana Díaz Municipio, Puerto Rico",72,075,72075
,,,,1,2157,2708,1146,802,782,20,1562,1283,1121,162,2708,14135,0.5244,33.2,3895,8286,8086,19,0,0,7,174,"Las Marías Municipio, Puerto Rico",72,083,72083
,,,,95,7744,10535,4039,2920,2824,96,6496,5377,5147,230,10535,15140,0.5241,35.1,12836,33262,31456,5,38,0,0,1763,"Corozal Municipio, Puerto Rico",72,047,72047
,,,,0,1940,3833,1706,1270,1213,57,2127,1712,1591,121,3833,20844,0.4151,35.1,5209,10770,10095,37,0,27,38,573,"Maunabo Municipio, Puerto Rico",72,095,72095
,,,,105,37394,52042,20873,13250,12653,597,31169,23417,22140,1277,52042,17069,0.572,34.0,65901,137042,128148,706,816,64,208,7100,"Ponce Municipio, Puerto Rico",72,113,72113
,,,,367,27091,22138,6756,4842,4743,99,15382,12909,12513,396,22138,28834,0.5014,36.9,26205,72714,67208,488,242,69,65,4642,"Toa Alta Municipio, Puerto Rico",72,135,72135
,,,,546,27340,27400,10165,6678,6429,249,17235,12799,12059,740,27400,25105,0.479,35.7,34692,77505,70451,859,737,127,298,5033,"Toa Baja Municipio, Puerto Rico",72,137,72137
,,,,0,2467,2258,1117,658,570,88,1141,761,633,128,2258,14936,0.4541,33.7,4908,8642,7593,0,9,0,0,1040,"Vieques Municipio, Puerto Rico",72,147,72147
,,,,0,8099,11541,4574,3086,2802,284,6967,5174,4774,400,11541,16295,0.5098,35.6,14509,33455,31694,36,40,0,0,1685,"Yabucoa Municipio, Puerto Rico",72,151,72151
,,,,73,11119,12830,4937,3527,3311,216,7893,6393,6095,298,12830,16738,0.5011,33.1,17704,37940,35500,59,105,12,74,2190,"Aguada Municipio, Puerto Rico",72,003,72003
,,,,682,43761,48184,17526,11472,10847,625,30658,24022,21739,2283,48184,25136,0.5277,36.5,57542,128334,117912,1309,791,44,242,8036,"Caguas Municipio, Puerto Rico",72,025,72025
,,,,75,11655,12942,4730,3058,3001,57,8212,6706,6338,368,12942,19726,0.5089,35.2,15834,39493,37304,144,124,13,64,1844,"Cidra Municipio, Puerto Rico",72,041,72041
,,,,9,10928,13104,4714,3062,2956,106,8390,6486,6048,438,13104,19692,0.5038,35.1,16204,38857,37068,184,174,9,0,1422,"Coamo Municipio, Puerto Rico",72,043,72043
,,,,37,11942,11602,4115,2944,2857,87,7487,6077,5552,525,11602,30732,0.5472,36.7,15847,36697,34202,251,284,0,57,1903,"Dorado Municipio, Puerto Rico",72,051,72051
,,,,21,5207,6582,2676,1930,1778,152,3906,2928,2775,153,6582,21850,0.4744,34.8,10469,18106,16413,195,116,0,84,1298,"Luquillo Municipio, Puerto Rico",72,089,72089
,,,,1,6923,8720,3076,2216,2095,121,5644,4640,4504,136,8720,17036,0.4964,35.2,10753,28256,27042,61,46,0,0,1107,"Barranquitas Municipio, Puerto Rico",72,019,72019
,,,,34,4705,6759,2466,1759,1702,57,4293,3512,3327,185,6759,15099,0.5376,35.0,8817,20886,20078,27,110,0,108,563,"Orocovis Municipio, Puerto Rico",72,107,72107
,,,,114,10823,13772,5044,3175,3032,143,8728,6777,6403,374,13772,19380,0.4967,35.9,16202,37153,34659,316,112,0,0,2066,"San Lorenzo Municipio, Puerto Rico",72,129,72129
,,,,35,3459,4224,1933,1136,1112,24,2291,1797,1660,137,4224,18309,0.5156,33.5,7404,11505,10602,165,80,0,0,658,"Ceiba Municipio, Puerto Rico",72,037,72037
,,,,10,3679,5831,2330,1616,1535,81,3501,3023,2895,128,5831,16867,0.5226,34.4,7267,16498,15686,31,0,0,37,744,"Ciales Municipio, Puerto Rico",72,039,72039
,,,,61,10511,14670,5510,3716,3613,103,9160,7037,6721,316,14670,16540,0.5091,33.9,20258,41431,38505,209,358,0,61,2298,"Isabela Municipio, Puerto Rico",72,071,72071
,,,,17,3137,4837,1873,1325,1325,0,2964,2427,2355,72,4837,14808,0.5037,35.5,6169,14258,13218,15,9,0,0,1016,"Jayuya Municipio, Puerto Rico",72,073,72073
,,,,32,6572,9967,3813,2610,2534,76,6154,5047,4914,133,9967,16532,0.5357,33.3,12314,25481,23945,95,20,0,66,1355,"Lares Municipio, Puerto Rico",72,081,72081
,,,,7438,121692,142699,53273,29693,27936,1757,89426,58405,53181,5224,142699,22710,0.6194,36.0,191126,331817,271192,17091,11644,1735,9079,21076,"San Juan Municipio, Puerto Rico",72,127,72127
,,,,164,10139,11918,4398,3050,3023,27,7520,6175,5946,229,11918,20048,0.5383,35.0,15935,36526,34143,180,201,30,77,1895,"Vega Alta Municipio, Puerto Rico",72,143,72143
,,,,0,1200,1846,812,573,508,65,1034,906,839,67,1846,12441,0.4841,30.6,2592,6075,5668,0,190,0,51,166,"Maricao Municipio, Puerto Rico",72,093,72093
54676.0,2633.0,811.0,281.0,107,26039,21648,6609,3980,3826,154,15039,11571,10313,1258,21648,52500,0.4276,37.8,24132,54427,50953,434,453,9,109,2469,"Seneca County, Ohio",39,147,39147
368549.0,8830.0,3826.0,633.0,2179,174956,153460,49323,30069,28435,1634,104137,77561,70351,7210,153460,53860,0.4409,38.4,166725,367654,340561,4245,1896,422,1274,19256,"Stark County, Ohio",39,151,39151
36212.0,1483.0,196.0,44.0,58,15630,14476,4914,2879,2708,171,9562,7594,7168,426,14476,46606,0.4235,39.4,16455,36166,32247,160,52,29,6,3672,"Coshocton County, Ohio",39,031,39031
199268.0,9971.0,3709.0,1120.0,258,102223,69985,17989,11787,11469,318,51996,44599,42267,2332,69985,106908,0.425,39.0,73234,200222,178822,7847,6124,368,967,6094,"Delaware County, Ohio",39,041,39041
92907.0,3218.0,791.0,314.0,185,47022,35298,12243,8485,8099,386,23055,19225,17823,1402,35298,82303,0.4647,38.9,37179,93087,82694,1619,584,34,108,8048,"Geauga County, Ohio",39,055,39055
28159.0,994.0,85.0,36.0,105,12124,11286,3594,2223,2103,120,7692,6273,5830,443,11286,52363,0.4097,37.6,13410,27858,26117,84,70,9,4,1574,"Hocking County, Ohio",39,073,39073
227940.0,5285.0,2616.0,780.0,1127,115994,96361,31343,19594,18553,1041,65018,47824,42888,4936,96361,64466,0.4149,38.8,102964,227907,206657,6829,3706,501,1518,8696,"Lake County, Ohio",39,085,39085
76321.0,3654.0,647.0,67.0,256,30609,28802,8639,5299,5076,223,20163,16063,14742,1321,28802,51092,0.4463,37.7,32025,71236,66386,380,287,0,0,4183,"Ross County, Ohio",39,141,39141
1233279.0,22828.0,20552.0,7517.0,26640,581691,540965,163352,86365,81369,4996,377613,249490,220492,28998,540965,50366,0.5113,38.2,618395,1232447,1081276,52962,31268,3303,6018,57620,"Cuyahoga County, Ohio",39,035,39035
43103.0,1256.0,86.0,31.0,53,19897,12342,3502,2488,2308,180,8840,7719,7494,225,12342,63753,0.4183,40.6,13604,43079,25351,162,26,0,3,17537,"Holmes County, Ohio",39,075,39075
104065.0,4039.0,1621.0,440.0,131,50331,41043,13327,8070,7742,328,27716,21149,18830,2319,41043,61041,0.427,39.0,44320,104310,96684,959,795,132,124,5616,"Miami County, Ohio",39,109,39109
13787.0,147.0,71.0,16.0,28,5086,5745,2238,1317,1283,34,3507,2607,2494,113,5745,45289,0.4689,40.1,7489,13805,12802,71,13,0,1,918,"Monroe County, Ohio",39,111,39111
197854.0,4085.0,1832.0,246.0,480,85687,85621,30121,17961,17186,775,55500,40247,36451,3796,85621,47280,0.4529,38.1,95687,196897,180534,2400,533,90,173,13167,"Trumbull County, Ohio",39,155,39155
128894.0,9904.0,2597.0,775.0,112,66792,50589,13207,8215,7807,408,37382,27526,22864,4662,50589,62390,0.4477,36.6,53962,128845,119910,1768,1772,99,541,4755,"Wood County, Ohio",39,173,39173
52994.0,2810.0,630.0,132.0,99,24986,20417,6523,4210,4031,179,13894,10593,9425,1168,20417,52823,0.4143,37.7,22312,52915,47566,410,242,0,124,4573,"Ashland County, Ohio",39,005,39005
4898.0,305.0,41.0,0.0,0,2108,1689,561,377,377,0,1128,862,831,31,1689,52428,0.47,42.2,2448,4826,3977,3,61,0,52,733,"Dewey County, Oklahoma",40,043,40043
3717.0,171.0,103.0,12.0,0,1467,1258,464,233,233,0,794,594,574,20,1258,46154,0.4102,44.1,1885,3730,3049,29,194,26,180,252,"Harper County, Oklahoma",40,059,40059
46217.0,2690.0,1206.0,128.0,66,20809,15512,4678,2952,2845,107,10834,9030,8484,546,15512,65357,0.4628,39.2,17497,46284,39808,573,332,122,584,4865,"Logan County, Oklahoma",40,083,40083
637202.0,18486.0,17343.0,3450.0,1881,309263,252661,64747,37987,36170,1817,187914,137768,123318,14450,252661,55517,0.4859,39.6,282675,641435,516899,16469,18307,2903,19537,67320,"Tulsa County, Oklahoma",40,143,40143
51237.0,1819.0,1879.0,149.0,32,22017,20455,6955,4048,3895,153,13500,10579,9854,725,20455,54997,0.4708,39.9,23740,51473,42634,733,1092,120,378,6516,"Washington County, Oklahoma",40,147,40147
2704.0,72.0,22.0,3.0,0,1171,1113,335,224,212,12,778,603,547,56,1113,48344,0.4537,41.7,1529,2618,2139,65,16,33,70,295,"Harmon County, Oklahoma",40,057,40057
12537.0,609.0,108.0,12.0,0,4569,4931,1730,1161,1088,73,3201,2568,2408,160,4931,42348,0.4466,40.4,6179,12623,10249,36,79,29,62,2168,"Haskell County, Oklahoma",40,061,40061
38247.0,2028.0,573.0,57.0,72,14773,14724,5204,3042,2883,159,9520,7488,6828,660,14724,42998,0.4702,38.9,17910,38077,31447,152,176,20,65,6217,"Okmulgee County, Oklahoma",40,111,40111
46813.0,2495.0,694.0,34.0,40,18849,18263,6383,3954,3819,135,11880,9320,8863,457,18263,49103,0.4431,39.7,21790,45806,39630,343,139,76,59,5559,"Osage County, Oklahoma",40,113,40113
6088.0,303.0,267.0,0.0,0,2182,2371,846,477,452,25,1525,1247,1168,79,2371,39895,0.5181,42.2,3398,6013,4829,71,46,30,11,1026,"Jefferson County, Oklahoma",40,067,40067
60943.0,1615.0,1843.0,619.0,91,28852,23541,6861,3821,3687,134,16680,12840,11816,1024,23541,54006,0.4467,41.9,26803,59739,47841,1167,1951,279,1641,6860,"Garfield County, Oklahoma",40,047,40047
27456.0,570.0,180.0,19.0,6,11046,10447,3490,2117,2027,90,6957,5442,5096,346,10447,47125,0.4435,42.2,12882,27584,23026,276,179,14,347,3742,"Garvin County, Oklahoma",40,049,40049
43578.0,2259.0,987.0,27.0,16,17079,17816,6221,3771,3594,177,11595,8887,8182,705,17816,46784,0.4578,41.7,23095,42174,35057,212,119,71,484,6231,"Pittsburg County, Oklahoma",40,121,40121
37875.0,1721.0,558.0,78.0,123,17312,14278,4215,2727,2647,80,10063,7539,6691,848,14278,50392,0.4503,38.9,16881,37859,31158,297,228,44,275,5857,"Pontotoc County, Oklahoma",40,123,40123
3634.0,135.0,169.0,0.0,2,1554,1377,524,311,308,3,853,659,585,74,1377,51302,0.5526,41.9,1907,3652,3140,16,10,6,39,441,"Roger Mills County, Oklahoma",40,129,40129
20476.0,1148.0,430.0,120.0,0,9280,7495,2139,1293,1271,22,5356,4268,4053,215,7495,60147,0.4279,40.5,9039,19708,16459,277,655,26,349,1942,"Woodward County, Oklahoma",40,153,40153
48201.0,2715.0,849.0,40.0,46,19404,16665,5275,3132,3009,123,11390,8400,7598,802,16665,42774,0.4729,38.1,22157,48254,37208,251,622,72,719,9382,"Cherokee County, Oklahoma",40,021,40021
42085.0,1147.0,1365.0,12.0,17,15623,16739,7099,4653,4466,187,9640,7445,6847,598,16739,41696,0.4632,39.3,25474,42058,33593,334,245,31,235,7620,"Delaware County, Oklahoma",40,041,40041
3956.0,273.0,74.0,0.0,0,1739,1614,626,336,317,19,988,730,688,42,1614,53245,0.4387,41.3,2274,3959,3341,35,41,2,10,530,"Ellis County, Oklahoma",40,045,40045
54617.0,2223.0,775.0,120.0,31,24346,19857,5782,3925,3762,163,14075,11653,10937,716,19857,60875,0.4475,40.9,22845,54542,47505,411,359,92,267,5908,"Grady County, Oklahoma",40,051,40051
80781.0,7473.0,3644.0,1041.0,277,36428,30788,7071,4440,4314,126,23717,16682,12429,4253,30788,41603,0.5208,36.4,36325,80350,65868,1276,3800,54,697,8655,"Payne County, Oklahoma",40,119,40119
71283.0,3590.0,1307.0,32.0,20,29767,25917,8091,4853,4640,213,17826,14140,13263,877,25917,49250,0.4498,38.7,29803,70235,59165,511,341,74,261,9883,"Pottawatomie County, Oklahoma",40,125,40125
70464.0,2417.0,672.0,45.0,57,30165,26427,8366,5457,5294,163,18061,14358,13448,910,26427,51318,0.4483,40.2,30421,70625,61175,486,421,123,385,8035,"Creek County, Oklahoma",40,037,40037
7306.0,359.0,485.0,84.0,32,2883,2807,1033,634,608,26,1774,1452,1271,181,2807,42280,0.443,40.4,4007,7070,5785,65,138,100,235,747,"Tillman County, Oklahoma",40,141,40141
11040.0,615.0,162.0,13.0,0,4726,4224,1317,784,770,14,2907,2322,2171,151,4224,53274,0.4259,41.7,5404,10923,9411,53,123,33,32,1271,"Washita County, Oklahoma",40,149,40149
5820.0,324.0,112.0,4.0,0,2265,2195,784,514,508,6,1411,1157,1100,57,2195,50885,0.436,40.0,2998,5729,4854,18,13,0,0,844,"Cotton County, Oklahoma",40,033,40033
8816.0,481.0,139.0,15.0,0,3667,3571,1225,708,651,57,2346,1745,1641,104,3571,38019,0.4592,41.2,5148,8687,7341,61,69,8,37,1171,"Kiowa County, Oklahoma",40,075,40075
49449.0,1197.0,1503.0,61.0,12,18972,18261,6164,3820,3670,150,12097,9754,9035,719,18261,40677,0.4497,40.2,22074,48819,39422,266,346,93,842,7850,"Le Flore County, Oklahoma",40,079,40079
32642.0,330.0,373.0,25.0,42,12558,12646,4220,2499,2381,118,8426,6710,6414,296,12646,37061,0.4557,41.7,15682,32639,24813,321,265,53,333,6854,"McCurtain County, Oklahoma",40,089,40089
7627.0,399.0,115.0,12.0,0,3290,3123,1057,640,603,37,2066,1697,1607,90,3123,54332,0.4308,42.5,3684,7586,6427,217,161,17,64,700,"Major County, Oklahoma",40,093,40093
40648.0,1249.0,422.0,43.0,37,17070,15983,5137,3203,3179,24,10846,8931,8229,702,15983,50345,0.4319,40.2,19524,40611,33979,162,202,26,87,6155,"Mayes County, Oklahoma",40,097,40097
775472.0,25724.0,20260.0,4159.0,2060,373566,301570,75806,44482,42451,2031,225764,163081,143895,19186,301570,54520,0.4911,39.4,338682,775218,619069,23139,24390,4215,28758,75647,"Oklahoma County, Oklahoma",40,109,40109
28932.0,1727.0,1066.0,73.0,14,13728,10653,2686,1478,1471,7,7967,6071,5279,792,10653,49900,0.4678,39.5,12636,28625,23251,770,781,41,549,3233,"Custer County, Oklahoma",40,039,40039
9945.0,273.0,156.0,0.0,4,3901,3268,1284,833,765,68,1984,1576,1502,74,3268,49399,0.4077,40.8,4588,9983,8086,226,238,38,138,1257,"Love County, Oklahoma",40,085,40085
21886.0,1823.0,442.0,36.0,100,8551,7578,2188,1405,1348,57,5390,4223,3915,308,7578,50721,0.4523,41.9,10046,20219,16916,392,119,57,291,2444,"Beckham County, Oklahoma",40,009,40009
14565.0,462.0,503.0,7.0,50,5087,5971,2135,1226,1188,38,3836,2810,2641,169,5971,34489,0.4877,40.2,7613,14624,11300,47,46,29,61,3141,"Choctaw County, Oklahoma",40,023,40023
24606.0,879.0,1635.0,63.0,3,11375,9762,2539,1638,1580,58,7223,5285,4876,409,9762,49703,0.4397,40.2,12116,23516,19538,419,543,78,266,2672,"Jackson County, Oklahoma",40,065,40065
34610.0,1269.0,249.0,33.0,8,14011,12763,4194,2528,2476,52,8569,6737,6367,370,12763,50671,0.4446,40.4,15386,34521,29458,120,160,28,65,4690,"Lincoln County, Oklahoma",40,081,40081
16234.0,894.0,128.0,11.0,14,6525,6179,2063,1405,1353,52,4116,3263,3109,154,6179,48009,0.4356,40.9,7832,16246,13646,56,29,11,25,2479,"Pawnee County, Oklahoma",40,117,40117
24484.0,1115.0,414.0,18.0,23,9174,9317,3091,1860,1756,104,6226,4899,4612,287,9317,39373,0.4471,40.4,11731,24405,19386,123,152,34,145,4565,"Seminole County, Oklahoma",40,133,40133
2162.0,33.0,55.0,1.0,0,965,977,381,189,184,5,596,439,415,24,977,46328,0.4812,43.7,1581,2157,1731,50,56,10,63,247,"Cimarron County, Oklahoma",40,025,40025
9483.0,527.0,346.0,48.0,1,3469,3898,1256,723,692,31,2642,1943,1824,119,3898,45792,0.4559,43.3,5052,8055,6969,56,65,8,37,920,"Blaine County, Oklahoma",40,011,40011
5494.0,222.0,99.0,0.0,3,2064,2227,818,455,448,7,1409,1088,1010,78,2227,40938,0.4976,42.4,2814,5511,4193,31,7,5,19,1256,"Coal County, Oklahoma",40,029,40029
4348.0,205.0,76.0,0.0,0,1894,1736,579,363,356,7,1157,828,787,41,1736,57727,0.391,42.8,2469,4292,3839,20,8,0,10,415,"Grant County, Oklahoma",40,053,40053
15430.0,221.0,150.0,105.0,3,7120,5609,1608,1035,972,63,4001,3186,3007,179,5609,57777,0.4798,42.6,6533,15525,12654,236,510,62,557,1506,"Kingfisher County, Oklahoma",40,073,40073
38839.0,2981.0,574.0,85.0,0,18481,14428,4246,2710,2604,106,10182,8757,8406,351,14428,67662,0.4221,41.1,15593,38857,33484,358,470,111,305,4129,"McClain County, Oklahoma",40,087,40087
16322.0,764.0,442.0,2.0,28,6359,6195,2514,1635,1587,48,3681,3009,2782,227,6195,45746,0.4354,40.9,10281,16305,12762,168,537,39,479,2320,"Marshall County, Oklahoma",40,095,40095
11207.0,730.0,212.0,0.0,31,5081,4515,1444,935,910,25,3071,2449,2333,116,4515,56117,0.4264,41.4,5349,11247,10167,23,13,0,44,1000,"Noble County, Oklahoma",40,103,40103
10230.0,348.0,144.0,13.0,9,4230,4099,1316,893,876,17,2783,2025,1957,68,4099,43145,0.4166,40.3,4874,10156,8325,19,52,2,43,1715,"Nowata County, Oklahoma",40,105,40105
90389.0,5173.0,1312.0,155.0,11,43569,34755,9696,6563,6344,219,25059,20649,19413,1236,34755,65434,0.4233,39.9,37994,90246,78874,1073,595,94,580,9030,"Rogers County, Oklahoma",40,131,40131
41135.0,980.0,1220.0,31.0,30,15747,15474,5223,3425,3360,65,10251,8179,7713,466,15474,40351,0.4374,39.2,19289,41268,32971,178,265,48,153,7653,"Sequoyah County, Oklahoma",40,135,40135
5800.0,358.0,85.0,12.0,4,2201,1870,639,389,387,2,1231,965,925,40,1870,61852,0.4579,41.4,2728,4745,4096,53,10,0,63,523,"Alfalfa County, Oklahoma",40,003,40003
8809.0,802.0,368.0,7.0,0,4365,3281,965,573,539,34,2316,1661,1391,270,3281,54282,0.4382,38.7,4424,8464,7430,82,9,0,19,924,"Woods County, Oklahoma",40,151,40151
276324.0,17789.0,9286.0,1389.0,449,140596,106172,25553,15989,15397,592,80619,62768,53961,8807,106172,64016,0.4344,38.2,114796,273487,233022,8111,6364,1087,2142,22761,"Cleveland County, Oklahoma",40,027,40027
11979.0,758.0,63.0,29.0,5,3882,3976,1382,875,841,34,2594,1994,1901,93,3976,38411,0.4585,40.5,5357,11045,8359,54,24,36,68,2504,"Okfuskee County, Oklahoma",40,107,40107
13659.0,1185.0,128.0,8.0,3,4710,5284,1830,1175,1143,32,3454,2693,2513,180,5284,39316,0.4692,40.2,6367,12337,10085,73,78,3,37,2061,"Atoka County, Oklahoma",40,005,40005
26078.0,1009.0,931.0,142.0,31,11333,10708,3760,2307,2172,135,6948,5765,4860,905,10708,52171,0.4372,38.1,11829,26078,23704,232,345,4,187,1606,"Union County, Oregon",41,061,41061
335390.0,12612.0,7114.0,1330.0,2596,150181,118038,36147,22708,21188,1520,81891,65642,59142,6500,118038,59625,0.4265,37.9,126210,333411,275672,13042,17892,1211,9997,15597,"Marion County, Oregon",41,047,41047
108118.0,2673.0,3960.0,138.0,121,42205,45456,19278,12661,11820,841,26178,20547,18178,2369,45456,47267,0.4397,38.1,50332,108435,99089,1558,998,97,445,6248,"Douglas County, Oregon",41,019,41019
23350.0,1966.0,537.0,73.0,84,8882,8094,3075,2212,2019,193,5019,4034,3615,419,8094,53277,0.4364,38.9,10092,22539,19271,598,571,70,211,1818,"Jefferson County, Oregon",41,031,41031
82101.0,6191.0,1845.0,324.0,255,36844,30305,10132,6546,6193,353,20173,16533,14536,1997,30305,62691,0.4292,37.1,32104,82617,72967,2435,2827,71,1094,3223,"Polk County, Oregon",41,053,41053
184909.0,5985.0,7856.0,901.0,236,89194,74397,24785,16940,15688,1252,49612,39531,34299,5232,74397,67043,0.4431,37.7,88714,185581,164956,3751,2702,562,1502,12108,"Deschutes County, Oregon",41,017,41017
123837.0,6165.0,2331.0,375.0,92,53881,47762,16022,10435,9766,669,31740,25436,22606,2830,47762,55893,0.4213,38.3,50416,124300,111132,1974,2309,82,1077,7726,"Linn County, Oregon",41,043,41043
103603.0,4824.0,2633.0,299.0,347,48006,36808,11881,7771,7228,543,24927,20457,18490,1967,36808,63902,0.4461,37.3,39069,102460,90361,3047,2832,535,1822,3863,"Yamhill County, Oregon",41,071,41071
15837.0,1093.0,534.0,0.0,7,6000,6921,2897,1644,1515,129,4024,2996,2714,282,6921,45998,0.4528,38.2,9027,15518,14003,93,117,21,93,1191,"Baker County, Oregon",41,001,41001
66047.0,2351.0,2920.0,108.0,150,26196,27886,9854,6139,5595,544,18032,13860,12075,1785,27886,46491,0.4485,39.2,33555,66285,58052,1467,1158,191,751,4666,"Klamath County, Oregon",41,035,41035
48163.0,1928.0,1780.0,154.0,203,18721,21298,9546,5985,5446,539,11752,8321,7111,1210,21298,47882,0.4455,37.6,31525,48167,41928,927,800,94,608,3810,"Lincoln County, Oregon",41,041,41041
90536.0,7626.0,4219.0,1271.0,1069,43301,35718,9861,6344,6045,299,25857,19812,14485,5327,35718,62077,0.4801,34.6,38399,90848,78269,2421,5495,103,891,3669,"Benton County, Oregon",41,003,41003
22866.0,1157.0,771.0,43.0,0,8777,9588,3953,2729,2627,102,5635,4327,3838,489,9588,49006,0.4187,37.3,10793,22949,20821,323,199,68,93,1445,"Crook County, Oregon",41,013,41013
1629.0,69.0,33.0,2.0,0,679,748,295,194,174,20,453,302,271,31,748,51071,0.4464,40.4,918,1640,1475,2,16,2,2,143,"Sherman County, Oregon",41,055,41055
7214.0,456.0,222.0,29.0,0,2921,3244,1169,816,663,153,2075,1731,1561,170,3244,40735,0.4314,39.7,3888,7157,6669,26,43,0,12,407,"Harney County, Oregon",41,025,41025
30128.0,1488.0,1416.0,74.0,20,10832,10062,3388,2089,1979,110,6674,5082,4718,364,10062,43313,0.4414,38.5,11888,26897,22686,573,1040,59,749,1790,"Malheur County, Oregon",41,045,41045
6947.0,138.0,252.0,8.0,0,3002,3214,1330,868,853,15,1884,1390,1226,164,3214,51224,0.4551,37.6,4215,6903,6448,93,47,0,14,301,"Wallowa County, Oregon",41,063,41063
1387.0,97.0,33.0,0.0,0,443,640,338,217,197,20,302,228,199,29,640,40926,0.3839,39.1,970,1415,1321,3,17,0,21,53,"Wheeler County, Oregon",41,069,41069
11108.0,529.0,464.0,75.0,7,4759,4108,1221,899,876,23,2887,2494,2249,245,4108,54269,0.3983,42.0,4633,11293,8730,416,1071,23,375,678,"Morrow County, Oregon",41,049,41049
63288.0,1629.0,2354.0,265.0,130,24461,27025,11513,6789,6237,552,15512,11593,10211,1382,27025,45051,0.4612,37.3,31124,62871,56696,1007,805,78,236,4049,"Coos County, Oregon",41,011,41011
22397.0,649.0,1363.0,48.0,15,7332,10546,5450,3328,2966,362,5096,3738,3327,411,10546,48440,0.4439,37.6,12948,22491,20520,498,103,0,134,1236,"Curry County, Oregon",41,015,41015
1871.0,59.0,28.0,6.0,0,788,842,341,235,214,21,501,309,279,30,842,47500,0.3769,40.9,1130,1868,1712,10,16,19,10,101,"Gilliam County, Oregon",41,021,41021
22906.0,280.0,684.0,167.0,34,11481,8600,2626,1531,1418,113,5974,4736,4304,432,8600,65679,0.4357,38.3,9914,23119,18385,914,1878,72,840,1030,"Hood River County, Oregon",41,027,41027
7798.0,519.0,262.0,88.0,6,3118,3515,1472,834,791,43,2043,1573,1422,151,3515,37898,0.4506,38.7,4507,7269,6424,109,181,3,36,516,"Lake County, Oregon",41,037,41037
796564.0,22562.0,32811.0,6969.0,50977,432196,326229,76749,44113,40171,3942,249480,176190,135989,40201,326229,69176,0.4701,37.7,348029,799365,653270,50512,42208,3734,14383,35258,"Multnomah County, Oregon",41,051,41051
55139.0,1211.0,2395.0,19.0,702,24722,22119,8209,5441,5098,343,13910,11050,10370,680,22119,65928,0.4291,38.4,38940,55051,47915,3261,778,172,278,2647,"Pike County, Pennsylvania",42,103,42103
40058.0,1194.0,641.0,95.0,23,19747,14794,5025,3149,3023,126,9769,8047,7505,542,14794,58997,0.4132,37.9,16442,40150,35431,282,207,43,28,4159,"Snyder County, Pennsylvania",42,109,42109
40587.0,783.0,691.0,26.0,19,17706,17235,6554,4172,3939,233,10681,8336,7617,719,17235,54966,0.4463,40.0,23319,40685,37401,443,161,38,69,2573,"Susquehanna County, Pennsylvania",42,115,42115
84783.0,2436.0,1256.0,92.0,182,37750,35164,12225,7515,7147,368,22939,17673,15949,1724,35164,50304,0.4317,38.8,44914,84149,76000,651,352,6,48,7092,"Crawford County, Pennsylvania",42,039,42039
270989.0,5696.0,5482.0,1164.0,2302,124756,110318,33786,19488,18541,947,76532,57151,49952,7199,110318,51529,0.4568,37.4,121362,267417,244521,5344,5330,248,862,11112,"Erie County, Pennsylvania",42,049,42049
14401.0,410.0,209.0,6.0,0,6623,5989,2163,1334,1278,56,3826,2940,2742,198,5989,53476,0.406,38.8,7257,14479,13495,64,30,18,15,857,"Fulton County, Pennsylvania",42,057,42057
24406.0,789.0,172.0,157.0,20,11189,9372,3123,1936,1814,122,6249,5001,4596,405,9372,53879,0.4075,39.1,11218,24386,21265,267,185,14,74,2581,"Juniata County, Pennsylvania",42,067,42067
141286.0,2877.0,1063.0,163.0,302,61484,58749,20076,11825,11311,514,38673,29472,27050,2422,58749,52280,0.4303,39.3,69870,135532,126187,1448,834,97,306,6660,"Schuylkill County, Pennsylvania",42,107,42107
27107.0,952.0,374.0,18.0,62,12648,10790,3885,2488,2324,164,6905,5370,4864,506,10790,59415,0.4101,38.7,13458,27074,25756,190,64,27,18,1019,"Wyoming County, Pennsylvania",42,131,42131
101479.0,3120.0,2710.0,180.0,203,49843,39345,13915,9031,8661,370,25430,20418,18987,1431,39345,67253,0.3945,38.4,42292,101190,92124,1489,1932,130,585,4930,"Adams County, Pennsylvania",42,001,42001
65271.0,1624.0,391.0,43.0,198,29130,28137,10312,6283,5910,373,17825,13808,12908,900,28137,51410,0.4181,39.6,32853,65307,62303,193,71,18,32,2690,"Armstrong County, Pennsylvania",42,005,42005
38496.0,1926.0,364.0,100.0,37,17492,14690,4983,2862,2669,193,9707,7635,6627,1008,14690,50923,0.4339,38.4,19250,38358,35096,385,148,4,24,2701,"Clinton County, Pennsylvania",42,035,42035
63269.0,1788.0,924.0,122.0,150,29128,26043,9373,5739,5358,381,16670,13212,11486,1726,26043,57006,0.4188,39.3,34795,63019,58805,1116,478,43,39,2538,"Carbon County, Pennsylvania",42,025,42025
160510.0,11971.0,6901.0,2587.0,4342,75715,58201,15143,9363,9043,320,43058,31210,23827,7383,58201,60403,0.472,36.1,66705,156625,134547,3833,9404,228,500,8113,"Centre County, Pennsylvania",42,027,42027
90660.0,3094.0,823.0,76.0,80,40846,39075,13788,7819,7430,389,25287,19330,17645,1685,39075,48671,0.4338,38.6,45465,87881,82854,625,562,46,117,3677,"Northumberland County, Pennsylvania",42,097,42097
300327.0,9388.0,7882.0,1291.0,2365,147865,114185,38468,24477,23567,910,75717,60831,54414,6417,114185,70471,0.4369,38.5,123159,300186,265727,13375,7339,662,1738,11345,"Northampton County, Pennsylvania",42,095,42095
51362.0,1359.0,545.0,63.0,78,22315,22050,7793,4746,4476,270,14257,10814,9875,939,22050,49945,0.4237,38.7,27620,51120,47715,219,76,9,11,3090,"Venango County, Pennsylvania",42,121,42121
164366.0,4753.0,2515.0,316.0,1696,79453,71167,25190,14464,13843,621,45977,34661,31397,3264,71167,57807,0.425,38.5,79463,164403,155367,2032,793,133,84,5994,"Beaver County, Pennsylvania",42,007,42007
208577.0,4903.0,4860.0,963.0,897,97873,87161,29059,16636,15874,762,58102,42368,37481,4887,87161,52821,0.4624,38.1,100262,206790,187897,5107,4513,404,1726,7143,"Lackawanna County, Pennsylvania",42,069,42069
40975.0,874.0,1309.0,105.0,150,17961,17147,5605,3450,3273,177,11542,8573,7587,986,17147,48647,0.4554,38.5,21275,39392,37293,274,282,27,9,1507,"McKean County, Pennsylvania",42,083,42083
130094.0,3154.0,1269.0,457.0,412,53685,54837,19666,11235,10647,588,35171,26490,23853,2637,54837,47364,0.4681,39.3,63795,127745,120062,841,853,18,33,5938,"Fayette County, Pennsylvania",42,051,42051
815283.0,25933.0,13538.0,3981.0,22501,426959,316206,98893,60592,58404,2188,217313,173686,159297,14389,316206,91546,0.4671,39.0,334387,809623,702463,49043,29351,2329,7661,18776,"Montgomery County, Pennsylvania",42,091,42091
79238.0,2766.0,522.0,184.0,91,33388,31248,11240,6709,6410,299,20008,15497,14095,1402,31248,49015,0.4222,38.5,39248,74436,70228,204,204,27,38,3735,"Clearfield County, Pennsylvania",42,033,42033
138087.0,5485.0,1918.0,1093.0,593,67294,53579,18001,11220,10750,470,35578,28432,25841,2591,53579,60281,0.4034,38.9,57609,138015,121157,2986,1937,237,962,10736,"Lebanon County, Pennsylvania",42,075,42075
113014.0,3119.0,1443.0,404.0,572,52349,45608,14634,9192,8733,459,30974,23198,21007,2191,45608,54241,0.4278,38.9,53428,111088,103017,1092,964,38,191,5786,"Lycoming County, Pennsylvania",42,081,42081
18110.0,961.0,270.0,34.0,5,8635,7404,2427,1310,1268,42,4977,3744,3415,329,7404,58333,0.4893,39.0,8200,17584,16026,378,251,4,38,887,"Montour County, Pennsylvania",42,093,42093
39328.0,575.0,680.0,24.0,87,17845,17115,6146,3759,3583,176,10969,8137,7496,641,17115,50250,0.4253,38.7,23629,39135,36604,340,126,14,53,1998,"Warren County, Pennsylvania",42,123,42123
184844.0,6234.0,2803.0,294.0,552,91639,76502,23764,14608,14111,497,52738,41048,37225,3823,76502,70668,0.4414,39.2,83257,184959,174800,2332,1958,59,117,5693,"Butler County, Pennsylvania",42,019,42019
30084.0,306.0,184.0,5.0,54,15131,14020,4657,2740,2528,212,9363,6728,6143,585,14020,53440,0.403,39.5,17790,30003,28893,143,110,0,0,857,"Elk County, Pennsylvania",42,047,42047
534384.0,12132.0,7973.0,2055.0,3177,267221,201620,63667,41127,39602,1525,137953,111953,101496,10457,201620,66056,0.4324,38.6,210985,535078,448941,13664,9704,1078,2328,59363,"Lancaster County, Pennsylvania",42,071,42071
110165.0,3013.0,2112.0,329.0,119,48255,46340,16741,9452,8980,472,29599,22508,20375,2133,46340,50696,0.4323,38.0,52262,107478,99737,996,405,43,81,6216,"Mercer County, Pennsylvania",42,085,42085
16670.0,450.0,291.0,14.0,2,6599,6480,2582,1598,1495,103,3898,2988,2791,197,6480,45419,0.4288,39.0,12958,16565,15329,78,38,6,0,1114,"Potter County, Pennsylvania",42,105,42105
40533.0,1123.0,645.0,50.0,89,17759,16310,5938,3754,3596,158,10372,8026,7204,822,16310,51324,0.4185,39.5,21810,40528,37026,357,161,5,16,2963,"Tioga County, Pennsylvania",42,117,42117
82164.0,1649.0,6621.0,1118.0,553,43176,34777,12499,7521,7060,461,22278,16697,14658,2039,34777,79454,0.4805,39.0,42563,79313,71421,2993,1878,143,768,2110,"Newport County, Rhode Island",44,005,44005
628656.0,6158.0,18668.0,5257.0,10334,305421,237971,67479,37207,34604,2603,170492,124033,109812,14221,237971,58974,0.4726,37.7,266330,626296,490918,60030,41437,3526,11457,18928,"Providence County, Rhode Island",44,007,44007
48444.0,1610.0,1966.0,122.0,507,24530,19217,6541,3980,3838,142,12676,9567,8688,879,19217,83092,0.4932,37.3,21053,48153,42716,3296,1085,12,77,967,"Bristol County, Rhode Island",44,001,44001
166349.0,3081.0,5455.0,363.0,143,70022,67598,21936,14036,13620,416,45662,34650,32006,2644,67598,51399,0.455,39.3,76776,166487,144333,2307,2843,347,2120,14537,"Aiken County, South Carolina",45,003,45003
8908.0,552.0,87.0,14.0,68,2832,3365,1340,748,697,51,2025,1382,1314,68,3365,27185,0.5028,38.6,4512,7950,7153,3,82,0,0,712,"Allendale County, South Carolina",45,005,45005
26800.0,1348.0,744.0,55.0,167,10447,9176,3372,2230,2166,64,5804,4505,4305,200,9176,49127,0.4841,39.0,10943,24442,21695,260,304,0,346,1837,"Edgefield County, South Carolina",45,037,45037
31940.0,530.0,151.0,17.0,29,12875,12653,4343,2452,2394,58,8310,5979,5648,331,12653,42442,0.4619,39.0,14755,32150,28480,154,88,136,36,3256,"Chester County, South Carolina",45,023,45023
37137.0,597.0,329.0,6.0,3,15735,15075,5212,2941,2765,176,9863,7309,6800,509,15075,36324,0.4572,38.3,20112,36861,31986,175,459,0,240,4001,"Colleton County, South Carolina",45,029,45029
30909.0,344.0,346.0,290.0,99,11395,11600,4362,2675,2466,209,7238,5281,5066,215,11600,32063,0.5265,39.3,14997,31207,27061,92,57,105,430,3462,"Marion County, South Carolina",45,067,45067
286651.0,12191.0,5954.0,944.0,221,138879,113104,32130,20617,19894,723,80974,62655,56854,5801,113104,61173,0.4384,39.6,124406,287397,250634,5172,4302,427,4535,22327,"Lexington County, South Carolina",45,063,45063
76718.0,2670.0,2539.0,178.0,185,31411,31978,12014,7798,7557,241,19964,15188,14075,1113,31978,49134,0.4868,38.3,40370,76923,66451,1191,739,47,921,7574,"Oconee County, South Carolina",45,073,45073
211862.0,10278.0,11588.0,1217.0,410,103330,76881,19832,14054,13481,573,57049,45191,41674,3517,76881,63309,0.4198,40.2,84098,209202,178643,4794,3118,651,3277,18719,"Berkeley County, South Carolina",45,015,45015
396075.0,10130.0,15702.0,2027.0,2381,203887,159195,43923,26953,25610,1343,115272,79565,66770,12795,159195,64022,0.5052,40.1,187953,393492,337416,7565,6391,888,6568,34664,"Charleston County, South Carolina",45,019,45019
61516.0,1940.0,1984.0,118.0,187,24640,25498,11855,7813,7573,240,13643,10229,9761,468,25498,48456,0.5044,37.9,35345,61382,54032,745,365,69,576,5595,"Georgetown County, South Carolina",45,043,45043
26409.0,677.0,547.0,49.0,13,8979,9613,3490,1972,1911,61,6123,4677,4158,519,9613,33586,0.4782,40.1,12049,23915,20842,154,68,24,73,2754,"Marlboro County, South Carolina",45,069,45069
196044.0,7316.0,4594.0,338.0,66,88685,76798,24455,15328,14627,701,52343,40479,37604,2875,76798,50865,0.457,38.7,88209,196603,173413,2390,1554,392,1716,17138,"Anderson County, South Carolina",45,007,45007
45462.0,1097.0,706.0,34.0,118,19053,17900,5897,3680,3601,79,12003,9417,8798,619,17900,41505,0.4377,40.2,21675,45568,39527,459,471,15,299,4797,"Chesterfield County, South Carolina",45,025,45025
69721.0,2248.0,992.0,51.0,157,29856,27612,8889,5324,5067,257,18723,14197,13068,1129,27612,42336,0.4785,37.9,31453,69282,59422,1002,661,12,1260,6925,"Greenwood County, South Carolina",45,047,45047
329534.0,4574.0,15363.0,825.0,402,144814,131143,51571,34489,32405,2084,79572,59869,52335,7534,131143,50704,0.4442,38.1,205922,330496,272706,7216,4863,1397,7085,37229,"Horry County, South Carolina",45,051,45051
64605.0,1413.0,1084.0,281.0,36,28031,24980,7992,5041,4869,172,16988,13037,12184,853,24980,51479,0.4416,39.6,29121,64650,56956,526,359,281,379,6149,"Kershaw County, South Carolina",45,055,45055
86851.0,1553.0,1080.0,253.0,62,34118,33060,11804,6860,6660,200,21256,14190,13397,793,33060,37955,0.4836,38.5,42797,86945,76243,557,398,16,162,9569,"Orangeburg County, South Carolina",45,075,45075
304027.0,10252.0,6861.0,705.0,502,138757,116645,35041,22046,21434,612,81604,62642,57693,4949,116645,52332,0.4573,39.0,129604,303389,259315,7911,5892,1227,4288,24756,"Spartanburg County, South Carolina",45,083,45083
14294.0,686.0,470.0,32.0,175,5310,5334,2128,1309,1295,14,3206,2226,2060,166,5334,31422,0.4499,37.0,7707,14184,12063,171,37,81,228,1604,"Bamberg County, South Carolina",45,009,45009
184348.0,2610.0,12126.0,861.0,411,81415,71477,30995,22297,21277,1020,40482,30619,28131,2488,71477,68377,0.4765,40.3,99204,178856,150523,5232,3910,822,4530,13839,"Beaufort County, South Carolina",45,013,45013
14498.0,408.0,166.0,0.0,3,6190,6179,2375,1392,1388,4,3804,2683,2522,161,6179,46339,0.4741,40.0,7464,14542,13013,65,113,61,30,1260,"Calhoun County, South Carolina",45,017,45017
30281.0,554.0,354.0,10.0,0,11570,11029,3466,2084,2007,77,7563,5518,5009,509,11029,30812,0.4974,37.6,13767,30392,25659,29,310,53,303,4038,"Dillon County, South Carolina",45,033,45033
20100.0,582.0,235.0,62.0,35,8373,7094,2494,1680,1656,24,4600,3576,3476,100,7094,45714,0.4444,39.8,9424,20046,16687,263,432,50,899,1715,"Saluda County, South Carolina",45,081,45081
406747.0,19816.0,26876.0,3321.0,2369,202733,151853,36435,22223,21463,760,115418,80205,70042,10163,151853,54767,0.4817,38.3,173043,387819,335978,9528,7413,676,4203,30021,"Richland County, South Carolina",45,079,45079
22308.0,417.0,138.0,16.0,146,8963,9191,3304,2299,2282,17,5887,3849,3639,210,9191,38213,0.4931,37.6,11890,22286,19793,86,69,0,0,2338,"Fairfield County, South Carolina",45,039,45039
19455.0,431.0,245.0,56.0,53,7433,6993,2435,1200,1146,54,4558,3124,3002,122,6993,33429,0.4132,39.3,9181,18212,16111,145,58,30,185,1683,"Hampton County, South Carolina",45,049,45049
500488.0,13543.0,16291.0,4885.0,929,244103,192975,54588,34960,33576,1384,138387,103182,93927,9255,192975,60351,0.4671,38.9,211100,502708,420596,14217,13824,1631,13587,38853,"Greenville County, South Carolina",45,045,45045
91548.0,1797.0,4534.0,166.0,265,38349,33899,12844,7862,7639,223,21055,16925,15936,989,33899,58849,0.4729,39.4,37426,90282,78668,1815,1991,119,531,7158,"Lancaster County, South Carolina",45,057,45057
156543.0,9019.0,4956.0,762.0,227,74715,55351,14482,9507,9124,383,40869,31327,29253,2074,55351,63080,0.428,39.2,60561,155427,134928,3283,2557,240,1763,12656,"Dorchester County, South Carolina",45,035,45035
136703.0,3183.0,1728.0,49.0,176,59931,52188,15805,10038,9759,279,36383,27121,24974,2147,52188,47058,0.4843,39.1,60746,136948,120229,1679,955,292,900,12893,"Florence County, South Carolina",45,041,45041
66007.0,3322.0,1404.0,282.0,43,27906,25563,8044,5279,5138,141,17519,13379,12444,935,25563,43304,0.46,38.2,31345,65629,56731,612,592,54,569,7071,"Laurens County, South Carolina",45,059,45059
9485.0,741.0,158.0,30.0,9,2743,3957,2090,1472,1442,30,1867,1216,1071,145,3957,43633,0.46,38.4,5634,8364,7657,143,39,0,6,519,"McCormick County, South Carolina",45,065,45065
122649.0,8512.0,5100.0,563.0,614,54802,47934,14292,9329,8971,358,33642,25915,21305,4610,47934,49573,0.4573,37.0,54264,123320,107641,1555,2194,134,540,11256,"Pickens County, South Carolina",45,077,45077
27177.0,1099.0,105.0,24.0,11,11470,11432,3869,2269,2198,71,7563,5708,5503,205,11432,41186,0.4742,40.1,14095,27039,24054,115,36,19,91,2724,"Union County, South Carolina",45,087,45087
31056.0,700.0,330.0,105.0,223,11359,12686,4889,2912,2822,90,7797,5469,5244,225,12686,32485,0.4805,39.2,15480,29799,26663,164,75,54,158,2685,"Williamsburg County, South Carolina",45,089,45089
2746.0,111.0,41.0,2.0,0,1488,1182,354,215,212,3,828,609,538,71,1182,64083,0.4424,44.3,1348,2622,2319,9,90,0,24,180,"Aurora County, South Dakota",46,003,46003
7085.0,123.0,280.0,6.0,4,3518,3218,957,581,572,9,2261,1762,1546,216,3218,58158,0.4261,39.7,3604,7095,6401,9,192,27,55,411,"Grant County, South Dakota",46,051,46051
5392.0,193.0,28.0,34.0,0,2768,2356,809,499,494,5,1547,1206,1110,96,2356,57720,0.4208,43.0,3106,5336,4890,20,67,0,3,356,"Tripp County, South Dakota",46,123,46123
2753.0,43.0,8.0,0.0,1,951,754,185,137,134,3,569,482,474,8,754,37400,0.4834,40.6,1009,2791,2020,4,0,0,16,751,"Ziebach County, South Dakota",46,137,46137
6448.0,169.0,220.0,12.0,0,3202,2624,881,519,497,22,1743,1294,1170,124,2624,54423,0.4761,43.0,3246,6358,5917,26,14,0,0,401,"Spink County, South Dakota",46,115,46115
6885.0,661.0,245.0,1.0,0,2757,2536,999,494,468,26,1537,1172,1022,150,2536,54737,0.4144,41.4,2969,5467,5159,5,4,20,0,279,"Bon Homme County, South Dakota",46,009,46009
34246.0,2563.0,1739.0,344.0,37,19098,12896,2814,1586,1536,50,10082,7065,5336,1729,12896,58136,0.4137,37.9,14563,34468,30565,354,1428,52,292,1777,"Brookings County, South Dakota",46,011,46011
6669.0,209.0,233.0,4.0,14,2839,2986,1304,711,651,60,1682,1245,1176,69,2986,50588,0.4036,37.6,4232,6560,5939,93,59,2,0,467,"Fall River County, South Dakota",46,047,46047
5912.0,439.0,120.0,18.0,0,2771,2256,562,398,388,10,1694,1454,1292,162,2256,67105,0.3574,41.5,2885,5851,5310,45,85,22,52,337,"Hamlin County, South Dakota",46,057,46057
3242.0,98.0,36.0,7.0,15,985,858,348,228,228,0,510,420,399,21,858,33295,0.5003,41.5,1278,3241,2346,7,10,0,7,871,"Jackson County, South Dakota",46,071,46071
8670.0,338.0,302.0,87.0,29,3977,3876,1664,1261,1202,59,2212,1820,1672,148,3876,58522,0.44,41.6,5172,8484,7476,132,86,0,56,734,"Custer County, South Dakota",46,033,46033
1300.0,38.0,8.0,0.0,1,661,597,218,131,129,2,379,273,258,15,597,57788,0.4125,44.5,720,1280,1216,8,0,0,0,56,"Hyde County, South Dakota",46,069,46069
2261.0,115.0,5.0,10.0,0,1073,895,311,152,145,7,584,414,402,12,895,55096,0.3875,46.0,1206,2250,2092,0,0,0,0,158,"Faulk County, South Dakota",46,049,46049
7198.0,498.0,107.0,1.0,0,3571,2903,1080,597,581,16,1823,1362,1313,49,2903,57089,0.4225,41.2,3403,7084,6660,8,43,0,11,362,"Hutchinson County, South Dakota",46,067,46067
5378.0,235.0,354.0,9.0,27,2696,2258,762,441,418,23,1496,1109,940,169,2258,55583,0.4605,40.1,3057,5353,4810,29,31,0,0,483,"Walworth County, South Dakota",46,129,46129
1984.0,46.0,5.0,0.0,0,594,564,114,75,72,3,450,365,350,15,564,34808,0.4712,38.1,657,2026,1230,0,0,0,0,796,"Buffalo County, South Dakota",46,017,46017
5441.0,222.0,106.0,4.0,8,2583,2574,988,552,528,24,1586,1166,1089,77,2574,46679,0.478,39.6,3793,5347,4764,11,16,0,4,552,"Day County, South Dakota",46,037,46037
2891.0,63.0,35.0,49.0,4,1386,1220,375,257,254,3,845,670,630,40,1220,58684,0.4451,41.9,1467,2831,2432,15,0,1,48,335,"Douglas County, South Dakota",46,043,46043
1286.0,64.0,46.0,0.0,0,683,532,159,119,109,10,373,301,278,23,532,59655,0.3555,44.8,701,1287,1194,0,9,0,12,72,"Harding County, South Dakota",46,063,46063
2283.0,51.0,59.0,4.0,4,1057,1030,418,257,250,7,612,359,346,13,1030,44574,0.4798,40.7,1437,2196,2007,10,11,10,0,158,"McPherson County, South Dakota",46,089,46089
10133.0,411.0,287.0,17.0,45,4496,3873,1356,870,828,42,2517,1870,1746,124,3873,50348,0.4584,40.2,5048,10117,8012,17,20,19,29,2020,"Roberts County, South Dakota",46,109,46109
1289.0,24.0,13.0,0.0,0,643,569,236,126,118,8,333,266,259,7,569,62153,0.5137,43.8,814,1305,1238,0,0,0,0,67,"Sully County, South Dakota",46,119,46119
55938.0,3879.0,2686.0,35.0,20,30529,19749,4459,2842,2793,49,15290,12724,11761,963,19749,82473,0.4418,40.4,20532,56492,52503,610,763,47,58,2511,"Lincoln County, South Dakota",46,083,46083
12547.0,727.0,483.0,26.0,14,6572,4700,1716,1042,1007,35,2984,2243,2064,179,4700,61846,0.4559,38.5,5785,12549,11438,99,128,0,6,878,"Lake County, South Dakota",46,079,46079
25242.0,1256.0,1120.0,58.0,30,13315,11048,3665,2203,2158,45,7383,5060,4044,1016,11048,52641,0.4556,38.1,14016,25202,22395,184,272,0,225,2126,"Lawrence County, South Dakota",46,081,46081
27634.0,1142.0,505.0,61.0,41,15162,12075,3299,1697,1522,175,8776,6745,5929,816,12075,56376,0.4328,38.9,13116,27685,25597,176,164,0,168,1580,"Codington County, South Dakota",46,029,46029
10143.0,300.0,240.0,0.0,0,4798,4164,1454,770,756,14,2710,2102,1798,304,4164,46508,0.4578,38.6,4839,10121,8570,48,32,0,7,1464,"Butte County, South Dakota",46,019,46019
4076.0,6.0,16.0,10.0,0,1280,1195,332,237,230,7,863,684,649,35,1195,35759,0.5273,40.9,1541,4150,3154,6,5,1,0,984,"Corson County, South Dakota",46,031,46031
3880.0,100.0,58.0,0.0,0,1920,1544,463,292,285,7,1081,840,783,57,1544,71324,0.4311,42.9,2057,3809,3596,2,37,0,0,174,"Edmunds County, South Dakota",46,045,46045
1470.0,44.0,47.0,0.0,0,745,673,249,162,157,5,424,294,274,20,673,54449,0.4125,45.1,988,1485,1456,6,0,1,0,22,"Campbell County, South Dakota",46,021,46021
3352.0,121.0,24.0,10.0,3,1127,984,261,166,166,0,723,589,562,27,984,47500,0.4366,40.6,1192,3387,2529,6,18,0,3,831,"Bennett County, South Dakota",46,007,46007
2000.0,27.0,20.0,0.0,0,894,822,276,164,160,4,546,442,442,0,822,42250,0.4465,43.4,1102,1979,1753,8,0,0,0,218,"Haakon County, South Dakota",46,055,46055
778.0,8.0,42.0,0.0,0,410,408,148,79,79,0,260,171,159,12,408,46149,0.3847,44.9,576,793,668,0,6,0,0,119,"Jones County, South Dakota",46,075,46075
27433.0,2033.0,1621.0,129.0,0,15053,11027,2932,1802,1735,67,8095,6291,5845,446,11027,60578,0.403,40.5,12065,26511,23412,300,155,14,39,2591,"Meade County, South Dakota",46,093,46093
8194.0,452.0,113.0,20.0,1,4183,3498,1146,675,659,16,2352,1858,1693,165,3498,59242,0.4385,39.9,4031,8141,7568,26,69,0,0,478,"Turner County, South Dakota",46,125,46125
38438.0,692.0,1259.0,254.0,16,20679,16305,4573,2495,2385,110,11732,8426,7497,929,16305,58216,0.4455,40.2,18018,38354,33834,583,769,72,98,2998,"Brown County, South Dakota",46,013,46013
3358.0,130.0,75.0,0.0,0,1599,1045,343,189,186,3,702,597,577,20,1045,64696,0.3598,40.4,1204,3393,3162,2,2,0,0,227,"Hanson County, South Dakota",46,061,46061
5453.0,478.0,76.0,0.0,0,2826,2228,609,396,396,0,1619,1276,1070,206,2228,61507,0.3919,41.3,2525,5397,4827,62,19,13,37,439,"McCook County, South Dakota",46,087,46087
2032.0,40.0,0.0,0.0,11,539,661,202,135,135,0,459,360,347,13,661,30650,0.4975,39.5,809,2010,1317,4,0,0,0,689,"Mellette County, South Dakota",46,095,46095
6430.0,233.0,75.0,45.0,3,3188,2640,868,556,515,41,1772,1346,1250,96,2640,61538,0.4216,40.7,2900,6451,5713,89,40,9,19,581,"Moody County, South Dakota",46,101,46101
109349.0,3912.0,4240.0,650.0,414,54452,44074,13407,8154,7573,581,30667,22011,19791,2220,44074,57039,0.455,38.9,48685,107918,94143,1104,974,123,431,11143,"Pennington County, South Dakota",46,103,46103
15242.0,678.0,846.0,209.0,14,7921,6619,1901,1135,1041,94,4718,3627,3263,364,6619,70378,0.4697,40.1,7136,15206,13913,127,345,0,29,792,"Union County, South Dakota",46,127,46127
2177.0,102.0,80.0,0.0,27,1124,948,317,173,173,0,631,451,411,40,948,52910,0.4029,43.9,1343,2167,2017,11,14,0,0,125,"Miner County, South Dakota",46,097,46097
22224.0,274.0,1886.0,86.0,55,9474,9101,3506,2259,2105,154,5595,4295,3533,762,9101,53715,0.4332,38.4,10043,22196,20325,307,234,0,107,1223,"Asotin County, Washington",53,003,53003
19324.0,972.0,165.0,347.0,14,7405,5973,1392,973,948,25,4581,3858,3623,235,5973,48294,0.4486,41.5,6608,19379,13693,1079,1410,127,2157,913,"Adams County, Washington",53,001,53001
2207.0,18.0,155.0,36.0,0,861,984,382,220,216,4,602,467,438,29,984,55900,0.3668,38.8,1243,2208,2043,3,35,0,16,111,"Garfield County, Washington",53,023,53023
62947.0,3944.0,1440.0,166.0,399,24593,24278,9363,6611,6029,582,14915,11090,9792,1298,24278,57634,0.4203,37.1,33503,62564,56007,875,1379,43,1242,3018,"Mason County, Washington",53,045,53045
124469.0,5387.0,2438.0,708.0,491,55983,48493,17510,11473,10805,668,30983,24821,21992,2829,48493,67028,0.4319,38.0,53893,124010,105712,4640,4666,392,3120,5480,"Skagit County, Washington",53,057,53057
44294.0,1675.0,615.0,61.0,126,16425,17554,7037,4904,4640,264,10517,8149,7301,848,17554,51775,0.4423,38.3,21746,44409,40038,766,482,32,96,2995,"Stevens County, Washington",53,065,53065
499702.0,16898.0,18280.0,2132.0,6169,230085,202811,57767,34068,32082,1986,145044,109690,95516,14174,202811,56904,0.4545,37.5,216871,496256,446634,14282,9199,1059,2422,22660,"Spokane County, Washington",53,063,53063
10484.0,431.0,157.0,57.0,8,4159,4525,1852,1237,1172,65,2673,2164,2022,142,4525,54631,0.4023,39.5,6050,10458,9903,75,82,7,1,390,"Lincoln County, Washington",53,043,53043
75704.0,3389.0,1161.0,350.0,363,35013,28384,9821,6102,5705,397,18563,14157,12990,1167,28384,58795,0.4519,37.9,37693,75545,61735,3615,3025,447,2689,4034,"Chelan County, Washington",53,007,53007
31159.0,1427.0,1504.0,95.0,201,11470,14705,7781,5316,4755,561,6924,5118,4142,976,14705,55127,0.4689,37.0,18618,30486,27242,974,610,5,183,1472,"Jefferson County, Washington",53,031,53031
262857.0,8660.0,13416.0,881.0,11808,127515,103913,32391,21318,19984,1334,71522,56521,49839,6682,103913,75411,0.4166,41.2,112709,249790,222981,10438,4600,392,1299,10080,"Kitsap County, Washington",53,035,53035
2170639.0,39742.0,82461.0,34588.0,162252,1183040,882028,202829,124243,116241,8002,679199,500876,413322,87554,882028,94974,0.4672,39.0,935471,2182505,1619046,227279,220932,11052,46483,57713,"King County, Washington",53,033,53033
21529.0,967.0,706.0,35.0,26,7273,9279,4608,2969,2592,377,4671,3443,3128,315,9279,46733,0.4295,38.0,16213,21448,18942,567,658,10,246,1025,"Pacific County, Washington",53,049,53049
13327.0,601.0,586.0,0.0,11,4619,5727,2395,1638,1525,113,3332,2559,2346,213,5727,50591,0.432,38.9,8260,13266,12091,252,149,39,48,687,"Pend Oreille County, Washington",53,051,53051
16694.0,478.0,717.0,62.0,187,7658,8252,3827,2560,2334,226,4425,3166,2687,479,8252,63622,0.5007,36.3,14119,16735,14601,638,428,21,185,862,"San Juan County, Washington",53,055,53055
11727.0,439.0,295.0,36.0,8,5098,4816,1670,1282,1162,120,3146,2462,2236,226,4816,65181,0.4084,38.4,5865,11713,10828,190,231,2,7,455,"Skamania County, Washington",53,059,53059
48875.0,6495.0,3039.0,1358.0,1240,22214,17999,3530,1986,1801,185,14469,10148,6930,3218,17999,42745,0.5071,33.3,20841,48947,41769,1178,4049,38,287,1626,"Whitman County, Washington",53,075,53075
246339.0,4653.0,3962.0,1133.0,488,103557,83048,23609,15668,14777,891,59439,48764,45347,3417,83048,51637,0.4439,39.1,88698,246985,186265,11873,16380,2044,16298,14125,"Yakima County, Washington",53,077,53077
74846.0,1603.0,3046.0,270.0,307,28466,32958,15211,9391,8589,802,17747,13214,11722,1492,32958,52192,0.4362,37.1,37110,74196,65065,2271,1237,141,383,5099,"Clallam County, Washington",53,009,53009
105637.0,3720.0,3642.0,347.0,96,43638,41952,14219,8709,8022,687,27733,21535,19448,2087,41952,54506,0.4429,38.2,44711,105810,97250,1850,1186,196,971,4357,"Cowlitz County, Washington",53,015,53015
7491.0,499.0,325.0,4.0,10,2518,3060,1339,938,837,101,1721,1217,1110,107,3060,41939,0.479,37.9,4526,7511,6868,47,54,6,4,532,"Ferry County, Washington",53,019,53019
77331.0,3697.0,2106.0,103.0,106,30855,30618,11405,7218,6756,462,19213,15034,13281,1753,30618,53484,0.4252,37.8,35148,77301,68916,1100,1622,185,1107,4371,"Lewis County, Washington",53,041,53041
41605.0,2029.0,796.0,126.0,200,19108,15263,5041,3512,3295,217,10222,8591,7896,695,15263,62951,0.4355,38.8,17002,41889,33747,1727,2444,277,1948,1746,"Douglas County, Washington",53,017,53017
81985.0,3769.0,3886.0,368.0,951,37301,34768,13731,9142,8534,608,21037,16969,15108,1861,34768,68604,0.4229,38.8,41902,76706,67466,3801,1716,147,412,3164,"Island County, Washington",53,029,53029
865076.0,31938.0,30769.0,5271.0,16165,417456,323296,84052,52989,49855,3134,239244,187227,166751,20476,323296,72113,0.4233,38.9,347022,854265,732586,43937,26188,3211,10954,37389,"Pierce County, Washington",53,053,53053
90467.0,6004.0,1639.0,534.0,165,39130,26723,5548,3611,3447,164,21175,18155,17003,1152,26723,63584,0.4057,39.6,28063,89836,64433,5114,7451,627,7472,4739,"Franklin County, Washington",53,021,53021
59686.0,3686.0,2742.0,221.0,223,26080,22646,7552,4684,4410,274,15094,11653,10268,1385,22646,57858,0.451,36.5,24745,57227,48910,1998,2172,138,1623,2386,"Walla Walla County, Washington",53,071,53071
218644.0,9154.0,6549.0,1165.0,2626,104723,86523,26223,16836,15486,1350,60300,46398,36628,9770,86523,62984,0.4406,36.0,96690,219395,186291,10476,8925,529,2262,10912,"Whatcom County, Washington",53,073,53073
11555.0,351.0,69.0,0.0,13,4875,4607,1915,1035,980,55,2692,2059,1904,155,4607,42216,0.4102,38.6,6667,11505,10579,38,0,0,0,888,"Grant County, West Virginia",54,023,54023
23075.0,348.0,446.0,17.0,25,9074,9288,3825,2367,2215,152,5463,4281,3924,357,9288,47857,0.4099,38.9,14019,22809,20619,144,9,14,58,1965,"Hampshire County, West Virginia",54,027,54027
22265.0,597.0,1016.0,26.0,64,9849,9805,3666,2291,2246,45,6139,4548,4031,517,9805,51496,0.3935,38.9,10794,22221,20872,137,144,0,34,1034,"Brooke County, West Virginia",54,009,54009
8478.0,900.0,225.0,0.0,0,3024,2685,1214,893,848,45,1471,1132,1066,66,2685,45545,0.4353,41.8,3922,7759,7142,19,41,0,0,557,"Doddridge County, West Virginia",54,017,54017
13690.0,216.0,305.0,60.0,16,6288,5674,2129,1547,1466,81,3545,2808,2646,162,5674,47438,0.4382,40.6,8309,13748,12719,196,203,0,51,579,"Hardy County, West Virginia",54,031,54031
55762.0,2034.0,1337.0,46.0,84,24369,22926,7544,4571,4428,143,15382,11760,10589,1171,22926,50305,0.4398,38.8,26383,55960,52477,407,187,20,54,2815,"Marion County, West Virginia",54,049,54049
24021.0,209.0,483.0,10.0,4,6671,10501,3473,1996,1942,54,7028,5244,5008,236,10501,32764,0.4816,40.5,12856,24207,23074,38,0,0,0,1095,"Mingo County, West Virginia",54,059,54059
29184.0,542.0,1354.0,58.0,152,12903,12678,4971,2583,2512,71,7707,5631,5014,617,12678,45763,0.4278,38.3,14359,29125,26994,193,64,12,16,1846,"Hancock County, West Virginia",54,029,54029
30984.0,555.0,313.0,46.0,5,12621,12308,4755,2781,2663,118,7553,5696,5358,338,12308,48557,0.4504,39.1,15784,30934,28620,198,34,19,33,2030,"Marshall County, West Virginia",54,051,54051
24754.0,456.0,451.0,0.0,82,9420,10069,3860,2409,2309,100,6209,5006,4755,251,10069,40086,0.4452,39.2,13148,24938,23270,67,146,0,56,1399,"Nicholas County, West Virginia",54,067,54067
6962.0,242.0,78.0,4.0,0,3026,3142,1286,806,768,38,1856,1398,1273,125,3142,49118,0.3991,38.9,5350,6803,6445,27,0,8,0,323,"Tucker County, West Virginia",54,093,54093
8707.0,171.0,161.0,1.0,0,3064,3207,1306,757,754,3,1901,1345,1292,53,3207,43087,0.4714,39.6,5020,8734,7948,6,64,0,8,708,"Tyler County, West Virginia",54,095,54095
13892.0,594.0,109.0,11.0,0,4529,5562,2115,1305,1181,124,3447,2724,2489,235,5562,37373,0.4588,40.0,7443,13925,13184,31,20,0,0,690,"Roane County, West Virginia",54,087,54087
16726.0,680.0,311.0,3.0,0,6601,6614,2389,1556,1430,126,4225,3291,2934,357,6614,48578,0.4233,39.7,7513,16448,15318,66,71,0,38,955,"Taylor County, West Virginia",54,091,54091
83708.0,1367.0,1710.0,134.0,365,35132,35488,12028,7133,6790,343,23460,17471,15823,1648,35488,47321,0.4709,38.7,40269,84384,78782,645,313,5,26,4613,"Wood County, West Virginia",54,107,54107
7932.0,369.0,325.0,42.0,10,2627,2587,924,671,643,28,1663,1205,1028,177,2587,42636,0.4197,36.7,3556,6835,6090,6,82,0,0,657,"Gilmer County, West Virginia",54,021,54021
26488.0,524.0,271.0,0.0,0,9757,11034,3957,2390,2286,104,7077,5608,5326,282,11034,46078,0.4514,40.0,13090,26121,24727,99,79,44,0,1172,"Mason County, West Virginia",54,053,54053
13334.0,246.0,590.0,26.0,0,4904,5718,2249,1302,1273,29,3469,2514,2372,142,5718,38540,0.4379,41.4,7641,13316,12089,21,1,0,94,1111,"Monroe County, West Virginia",54,063,54063
7380.0,488.0,114.0,0.0,0,2864,2835,955,574,532,42,1880,1572,1525,47,2835,56838,0.4908,38.6,3404,6936,6576,5,0,0,0,355,"Pleasants County, West Virginia",54,073,54073
93435.0,3558.0,2223.0,188.0,574,37241,39064,11919,6638,6387,251,27145,17780,15082,2698,39064,40028,0.5097,37.8,46379,92831,84504,698,508,109,174,6838,"Cabell County, West Virginia",54,011,54011
55815.0,1186.0,2952.0,251.0,491,27051,20891,6392,4270,3971,299,14499,11827,10804,1023,20891,80430,0.4108,38.6,23177,56144,50860,1532,881,150,228,2493,"Jefferson County, West Virginia",54,037,54037
32664.0,645.0,324.0,8.0,29,9471,13816,4931,2963,2805,158,8885,7247,6818,429,13816,36168,0.4887,41.3,16853,32609,30203,28,29,0,0,2349,"Logan County, West Virginia",54,045,54045
6962.0,103.0,143.0,0.0,7,2926,3174,1393,824,819,5,1781,1380,1281,99,3174,42312,0.4476,39.2,5223,6879,6503,13,4,0,0,359,"Pendleton County, West Virginia",54,071,54071
67332.0,1890.0,1062.0,90.0,205,29808,27098,9098,5512,5211,301,18000,13957,12540,1417,27098,53022,0.4467,40.2,31707,67242,62791,346,233,18,11,3843,"Harrison County, West Virginia",54,033,54033
41716.0,1118.0,1150.0,73.0,234,18817,17193,6385,3411,3188,223,10808,7436,6674,762,17193,50584,0.5061,38.2,20930,41604,39172,458,179,43,17,1735,"Ohio County, West Virginia",54,069,54069
7230.0,422.0,175.0,0.0,16,2060,2826,1059,702,648,54,1767,1432,1307,125,2826,38382,0.4585,40.3,4009,7272,6797,12,47,0,0,416,"Calhoun County, West Virginia",54,013,54013
17600.0,191.0,609.0,8.0,24,7925,7185,2913,1925,1686,239,4272,3583,3224,359,7185,51745,0.4035,38.1,9976,17567,16112,234,46,0,0,1175,"Morgan County, West Virginia",54,065,54065
74703.0,2671.0,1105.0,133.0,59,27879,31203,11172,6910,6653,257,20031,15775,14482,1293,31203,43748,0.4642,39.5,36177,72971,67020,503,475,15,87,4871,"Raleigh County, West Virginia",54,081,54081
56259.0,1554.0,394.0,74.0,15,25175,21613,6675,4565,4431,134,14938,11946,11323,623,21613,60097,0.4372,38.8,24189,56108,52205,546,122,12,24,3199,"Putnam County, West Virginia",54,079,54079
16380.0,497.0,225.0,6.0,6,6401,6324,2219,1464,1363,101,4105,3040,2696,344,6324,38459,0.477,38.0,7914,16466,15538,68,50,0,0,810,"Barbour County, West Virginia",54,001,54001
18501.0,357.0,203.0,16.0,9,3700,7607,2865,1947,1832,115,4742,3536,3384,152,7607,27682,0.4655,39.6,11220,17248,16180,29,4,0,0,1035,"McDowell County, West Virginia",54,047,54047
40024.0,1210.0,823.0,13.0,99,13087,15124,5457,3273,3206,67,9667,7134,6753,381,15124,37988,0.4952,38.5,19355,40159,36800,128,127,0,138,2966,"Wayne County, West Virginia",54,099,54099
28624.0,824.0,263.0,61.0,20,10881,11334,4043,2726,2672,54,7291,5368,5109,259,11334,47837,0.4552,39.6,13408,28730,26891,108,120,0,25,1586,"Jackson County, West Virginia",54,035,54035
59347.0,1195.0,1756.0,88.0,75,21728,25216,9236,5442,5303,139,15980,12001,11043,958,25216,40784,0.4357,39.5,29997,59450,55176,408,101,0,67,3698,"Mercer County, West Virginia",54,055,54055
24190.0,850.0,359.0,75.0,8,9642,9713,3393,2117,1965,152,6320,4700,4392,308,9713,40322,0.4771,38.1,11398,24289,22355,34,103,0,0,1797,"Upshur County, West Virginia",54,097,54097
8302.0,218.0,82.0,5.0,0,2883,3781,1431,946,848,98,2350,1782,1698,84,3781,34927,0.4727,38.0,5450,8329,7839,2,0,0,0,488,"Webster County, West Virginia",54,101,54101
113687.0,2134.0,5345.0,186.0,288,55114,44221,11762,7724,7359,365,32459,25125,22786,2339,44221,62515,0.3998,39.2,48578,114881,104212,2191,1363,239,487,6389,"Berkeley County, West Virginia",54,003,54003
43097.0,823.0,521.0,80.0,54,15112,17441,6346,4026,3909,117,11095,8188,7798,390,17441,41394,0.4365,39.5,21496,42485,39200,105,169,10,18,2983,"Fayette County, West Virginia",54,019,54019
5663.0,271.0,216.0,6.0,11,2462,2898,1172,698,648,50,1726,1162,1012,150,2898,43798,0.434,39.0,6062,5583,5181,40,29,0,2,331,"Iron County, Wisconsin",55,051,55051
33965.0,1235.0,213.0,139.0,4,15719,12791,3754,2222,2116,106,9037,7135,6608,527,12791,54012,0.4174,42.9,15172,34104,26337,231,385,34,250,6867,"Clark County, Wisconsin",55,019,55019
87654.0,1745.0,2780.0,203.0,250,48356,34182,8216,5190,4953,237,25966,21132,19436,1696,34182,84756,0.4006,39.3,35862,88008,82798,1410,448,88,275,2989,"St. Croix County, Wisconsin",55,109,55109
37331.0,1430.0,377.0,27.0,15,18757,16036,5179,3338,3161,177,10857,8493,7720,773,16036,60908,0.3939,39.6,24197,37389,35420,219,139,33,105,1473,"Oconto County, Wisconsin",55,083,55083
27508.0,1119.0,319.0,43.0,68,13808,12625,4079,2437,2275,162,8546,6496,5842,654,12625,58541,0.3944,39.6,17142,27164,25940,104,99,4,38,979,"Lincoln County, Wisconsin",55,069,55069
50738.0,2360.0,503.0,39.0,45,25896,22305,6819,4031,3822,209,15486,11502,10144,1358,22305,58693,0.4242,39.9,25789,49858,46158,460,283,17,305,2635,"Waupaca County, Wisconsin",55,135,55135
44699.0,1407.0,716.0,105.0,70,21683,18907,6500,3896,3713,183,12407,9499,8487,1012,18907,52703,0.4386,39.7,24113,44662,40624,572,548,62,32,2824,"Barron County, Wisconsin",55,005,55005
16309.0,745.0,332.0,14.0,148,7198,7796,2957,1867,1795,72,4839,3747,3334,413,7796,47714,0.4966,38.1,16355,16123,14807,169,31,12,65,1039,"Sawyer County, Wisconsin",55,113,55113
18533.0,774.0,224.0,12.0,16,8846,7979,2766,1675,1579,96,5213,3906,3537,369,7979,55075,0.4154,40.2,10710,18576,16366,209,216,6,111,1668,"Green Lake County, Wisconsin",55,047,55047
13327.0,760.0,233.0,31.0,8,6294,6688,2435,1507,1399,108,4253,3044,2678,366,6688,47956,0.4159,39.3,11001,13237,12357,87,64,6,91,632,"Price County, Wisconsin",55,099,55099
15160.0,661.0,177.0,13.0,22,6885,6648,2581,1557,1447,110,4067,3098,2709,389,6648,52288,0.3957,39.9,9980,15174,13964,180,93,18,20,899,"Marquette County, Wisconsin",55,077,55077
40107.0,1108.0,995.0,89.0,44,18328,18473,6471,3823,3609,214,12002,8667,7645,1022,18473,50330,0.4243,39.2,30795,39895,37364,311,158,10,75,1977,"Marinette County, Wisconsin",55,075,55075
939577.0,18881.0,17257.0,4435.0,23314,453526,382175,92662,48907,46044,2863,289513,196975,167569,29406,382175,50606,0.4766,38.0,418866,942070,807462,32801,33122,2722,19175,46788,"Milwaukee County, Wisconsin",55,079,55079
5944.0,294.0,70.0,0.0,0,2876,2432,833,440,435,5,1599,1227,1158,69,2432,44083,0.4285,40.5,3206,5800,5109,39,6,0,7,639,"Shelby County, Missouri",29,205,29205
38053.0,3051.0,593.0,0.0,52,15191,13575,4200,2840,2688,152,9375,7743,7201,542,13575,50560,0.4182,38.9,14780,37753,32240,209,104,20,23,5157,"Webster County, Missouri",29,225,29225
5180.0,87.0,78.0,10.0,5,2586,2562,948,478,440,38,1614,1094,988,106,2562,50236,0.4395,40.1,2956,5145,4627,19,12,1,14,472,"Atchison County, Missouri",29,005,29005
16129.0,876.0,329.0,11.0,0,7390,6547,2130,1288,1241,47,4417,3538,3376,162,6547,47625,0.4564,40.8,7837,15977,14318,132,47,13,0,1467,"Bates County, Missouri",29,013,29013
18994.0,939.0,489.0,19.0,13,6607,7872,3918,2338,2146,192,3954,3142,2868,274,7872,40249,0.4669,38.8,14234,18902,16495,89,82,0,18,2218,"Benton County, Missouri",29,015,29015
6130.0,205.0,109.0,48.0,8,2473,2333,801,459,421,38,1532,1221,1141,80,2333,39530,0.4341,40.8,3263,6085,5100,12,0,0,0,973,"Carter County, Missouri",29,035,29035
7481.0,563.0,193.0,38.0,9,2938,3068,1167,812,743,69,1901,1501,1370,131,3068,40399,0.442,38.9,3947,7436,6334,70,21,6,16,989,"Dade County, Missouri",29,057,29057
193333.0,6363.0,2533.0,249.0,1236,93229,76974,22005,12941,12350,591,54969,43513,39594,3919,76974,61336,0.4366,38.6,82755,190867,174252,3978,2879,267,1845,7646,"Racine County, Wisconsin",55,101,55101
168642.0,10449.0,2549.0,257.0,574,86951,70594,19217,10632,10161,471,51377,37735,31608,6127,70594,58543,0.4463,38.2,75606,165571,152721,2860,2355,213,459,6963,"Winnebago County, Wisconsin",55,139,55139
8867.0,362.0,98.0,4.0,9,3658,4008,1386,842,801,41,2622,1907,1744,163,4008,45536,0.4378,37.7,9185,8767,7875,36,31,0,22,803,"Forest County, Wisconsin",55,041,55041
36533.0,1309.0,538.0,40.0,21,20231,15047,4590,2692,2563,129,10457,8058,7310,748,15047,64502,0.4157,39.7,16024,36548,34438,369,384,6,91,1260,"Green County, Wisconsin",55,045,55045
13975.0,518.0,270.0,14.0,21,6288,6376,2324,1428,1356,72,4052,2944,2639,305,6376,47532,0.4087,40.8,9189,13996,12681,78,45,3,33,1156,"Rusk County, Wisconsin",55,107,55107
40468.0,1552.0,346.0,60.0,42,19744,17004,5731,3554,3409,145,11273,8614,7738,876,17004,56531,0.4187,40.1,20890,40340,37468,194,167,46,75,2390,"Shawano County, Wisconsin",55,115,55115
18908.0,1091.0,59.0,175.0,9,8618,8612,3170,1794,1707,87,5442,4056,3721,335,8612,49491,0.4105,39.3,12565,18948,17517,103,140,1,128,1059,"Langlade County, Wisconsin",55,067,55067
183681.0,7156.0,2270.0,288.0,540,99297,73648,18754,10776,10296,480,54894,42359,38129,4230,73648,65572,0.4105,38.7,77016,184353,170456,3350,2279,192,832,7244,"Outagamie County, Wisconsin",55,087,55087
30187.0,767.0,305.0,98.0,56,13543,12071,4034,2413,2279,134,8037,6224,5783,441,12071,52459,0.4274,39.8,14096,30333,25952,189,96,5,92,3999,"Vernon County, Wisconsin",55,123,55123
56676.0,2824.0,806.0,170.0,31,29975,24112,7186,4225,3959,266,16926,13183,11985,1198,24112,68005,0.4094,39.8,26751,55743,51843,680,474,44,230,2472,"Columbia County, Wisconsin",55,021,55021
20144.0,584.0,215.0,83.0,23,10573,8341,2660,1660,1598,62,5681,4414,4115,299,8341,66192,0.3818,40.3,9430,20263,19182,102,227,7,116,629,"Kewaunee County, Wisconsin",55,061,55061
258326.0,7962.0,4319.0,931.0,1067,136941,105271,26405,14890,14135,755,78866,60140,53090,7050,105271,62340,0.4354,38.7,109645,258334,232278,5232,6725,715,2703,10681,"Brown County, Wisconsin",55,009,55009
102299.0,5928.0,3218.0,221.0,336,55270,40981,11093,6199,5824,375,29888,21907,17786,4121,40981,59476,0.4348,37.3,44089,102800,93002,2231,942,65,677,5883,"Eau Claire County, Wisconsin",55,035,55035
35024.0,1107.0,527.0,25.0,60,16357,15421,6078,3712,3482,230,9343,6920,6124,796,15421,56852,0.4599,38.5,31058,34834,32680,321,112,6,32,1683,"Oneida County, Wisconsin",55,085,55085
43015.0,1091.0,1135.0,30.0,34,21238,18450,5953,3756,3558,198,12497,9602,8745,857,18450,59994,0.4007,38.9,24655,42986,40079,276,160,30,42,2399,"Polk County, Wisconsin",55,095,55095
15507.0,610.0,376.0,21.0,25,6895,7236,2826,1805,1716,89,4410,3256,2967,289,7236,50280,0.436,38.6,13263,15516,14541,84,74,3,9,805,"Washburn County, Wisconsin",55,129,55129
396524.0,15759.0,5804.0,977.0,1316,212064,158808,50159,31188,29963,1225,108649,87534,80460,7074,158808,87277,0.4451,38.6,165664,397893,368276,11399,7488,165,1290,9275,"Waukesha County, Wisconsin",55,133,55133
102268.0,4962.0,2469.0,167.0,241,52757,40874,12285,7756,7485,271,28589,22345,19417,2928,40874,63776,0.4328,37.9,52379,102419,91665,2253,1780,305,1558,4858,"Walworth County, Wisconsin",55,127,55127
16061.0,676.0,372.0,24.0,26,7319,6654,2457,1518,1400,118,4197,3090,2797,293,6654,50595,0.4421,39.0,8978,15510,14462,97,44,0,0,907,"Crawford County, Wisconsin",55,023,55023
26180.0,1279.0,333.0,50.0,53,12103,10752,3678,2232,2068,164,7074,5353,4669,684,10752,53490,0.4449,39.5,15146,24967,22988,277,124,41,56,1481,"Juneau County, Wisconsin",55,057,55057
63195.0,2610.0,1078.0,178.0,47,33663,26222,7813,4870,4664,206,18409,13915,12488,1427,26222,59943,0.4161,39.5,30414,63223,57892,735,763,13,437,3383,"Sauk County, Wisconsin",55,111,55111
133475.0,4697.0,1393.0,195.0,357,72842,54302,15847,9986,9562,424,38455,30701,28395,2306,54302,77663,0.4068,39.2,56737,134160,126016,2219,853,47,323,4702,"Washington County, Wisconsin",55,131,55131
63087.0,3474.0,906.0,79.0,23,31494,25601,7781,4702,4551,151,17820,14129,12659,1470,25601,59742,0.4153,39.9,28385,61393,57285,499,236,36,67,3270,"Chippewa County, Wisconsin",55,017,55017
529539.0,14512.0,17289.0,4902.0,15549,303902,222929,50338,30312,28394,1918,172591,124405,97799,26606,222929,73893,0.4424,37.9,232924,532000,471068,18234,22166,919,5859,13754,"Dane County, Wisconsin",55,025,55025
42857.0,666.0,2042.0,231.0,261,21663,19011,5564,3291,3010,281,13447,9693,8460,1233,19011,53986,0.4204,37.8,23144,42715,39191,390,457,78,62,2537,"Douglas County, Wisconsin",55,031,55031
20260.0,961.0,279.0,71.0,15,9203,8199,2695,1541,1409,132,5504,4081,3674,407,8199,53650,0.4125,40.4,9933,19404,17490,156,64,13,202,1479,"Jackson County, Wisconsin",55,053,55053
23393.0,926.0,201.0,22.0,45,12402,9850,3022,1823,1748,75,6828,5289,4737,552,9850,64124,0.4274,40.6,10885,23460,22229,228,132,2,33,836,"Iowa County, Wisconsin",55,049,55049
87708.0,4492.0,1630.0,277.0,286,46591,35807,11718,7255,6932,323,24089,19637,18296,1341,35807,85215,0.4824,38.4,37445,88112,81721,2520,1427,39,288,2117,"Ozaukee County, Wisconsin",55,089,55089
70064.0,5115.0,918.0,480.0,188,37104,28675,7820,4814,4508,306,20855,15816,12874,2942,28675,58853,0.4347,37.4,30911,70343,64930,904,1208,138,505,2658,"Portage County, Wisconsin",55,097,55097
160487.0,3256.0,3440.0,275.0,449,78443,64739,18646,10786,10187,599,46093,35256,31248,4008,64739,57875,0.4128,38.6,69028,160864,146136,2821,2361,309,1986,7251,"Rock County, Wisconsin",55,105,55105
20099.0,585.0,162.0,28.0,22,10039,8614,2679,1633,1514,119,5935,4703,4348,355,8614,53020,0.4157,41.7,10720,20125,18392,79,83,29,95,1447,"Taylor County, Wisconsin",55,119,55119
19987.0,960.0,510.0,75.0,7,7598,9062,4109,2616,2441,175,4953,3652,3183,469,9062,46369,0.4238,38.0,17726,19000,17560,286,105,4,32,1013,"Adams County, Wisconsin",55,001,55001
14909.0,334.0,276.0,21.0,159,6843,7057,2859,1744,1662,82,4198,3266,2936,330,7057,56096,0.42,38.3,13335,14885,13714,137,72,9,30,923,"Bayfield County, Wisconsin",55,007,55007
45074.0,1665.0,937.0,159.0,38,21755,17915,5235,3094,2895,199,12680,9471,8633,838,17915,59587,0.4068,40.0,19914,44922,40018,503,344,17,242,3798,"Monroe County, Wisconsin",55,081,55081
72369.0,2455.0,795.0,120.0,54,35266,32332,10552,5996,5708,288,21780,15955,14158,1797,32332,54913,0.431,39.8,35068,72541,67964,756,702,123,176,2820,"Wood County, Wisconsin",55,141,55141
15428.0,517.0,270.0,20.0,157,7114,6565,2225,1193,1111,82,4340,3281,2749,532,6565,42510,0.441,35.7,9655,15407,14385,92,64,2,12,852,"Ashland County, Wisconsin",55,003,55003
4290.0,62.0,186.0,17.0,4,1886,1948,706,473,453,20,1242,905,834,71,1948,52181,0.4795,37.7,4825,4259,3990,15,18,0,0,236,"Florence County, Wisconsin",55,037,55037
83948.0,4940.0,1158.0,188.0,70,45365,32965,9735,5983,5624,359,23230,18727,16974,1753,32965,66291,0.4044,39.1,35818,84225,78170,984,1079,182,601,3209,"Jefferson County, Wisconsin",55,055,55055
46884.0,1060.0,2317.0,117.0,579,24170,17574,2996,1932,1859,73,14578,11629,10522,1107,17574,82659,0.3877,42.6,20264,46921,41518,485,173,234,553,3958,"Campbell County, Wyoming",56,005,56005
19082.0,361.0,1105.0,103.0,75,8858,6908,2139,1431,1265,166,4769,3587,3430,157,6908,66964,0.3876,38.9,9421,19163,16172,109,262,25,135,2460,"Lincoln County, Wyoming",56,023,56023
79479.0,1518.0,2427.0,233.0,232,40704,32799,8393,4549,4337,212,24406,18390,16192,2198,32799,62772,0.4362,40.8,36979,79211,67517,604,544,142,452,9952,"Natrona County, Wyoming",56,025,56025
13725.0,557.0,430.0,0.0,284,6551,5378,1558,900,882,18,3820,3170,2887,283,5378,69647,0.397,42.3,6678,13876,12518,29,119,23,94,1093,"Converse County, Wyoming",56,009,56009
2422.0,119.0,34.0,0.0,0,900,964,416,216,210,6,548,406,391,15,964,39150,0.4727,40.9,1328,2139,1830,0,0,7,0,302,"Niobrara County, Wyoming",56,027,56027
42844.0,853.0,2008.0,96.0,612,21188,15523,3546,2115,2037,78,11977,9423,8757,666,15523,74843,0.4065,39.6,19771,43246,36942,677,760,85,503,4279,"Sweetwater County, Wyoming",56,037,56037
40287.0,1061.0,581.0,117.0,3,16937,15727,5044,2987,2920,67,10683,7816,7247,569,15727,41125,0.4724,39.9,17975,40169,33753,564,730,37,1164,3921,"Warren County, Tennessee",47,177,47177
126677.0,6029.0,3850.0,917.0,331,58635,53859,15953,10061,9607,454,37906,26893,23423,3470,53859,48334,0.4877,37.8,60423,125931,111017,1545,2201,143,1231,9794,"Washington County, Tennessee",47,179,47179
33154.0,2122.0,702.0,139.0,29,14158,13640,4218,2420,2312,108,9422,7287,6365,922,13640,39937,0.4649,38.0,15615,33062,29409,217,178,17,162,3079,"Weakley County, Tennessee",47,183,47183
15972.0,529.0,114.0,57.0,28,5664,6762,2962,1589,1517,72,3800,2621,2315,306,6762,37512,0.4662,39.5,9115,15988,14359,174,24,19,29,1383,"Benton County, Tennessee",47,005,47005
14784.0,698.0,210.0,66.0,27,5291,4894,1730,1237,1105,132,3164,2529,2368,161,4894,44122,0.4754,39.9,5763,13636,11881,50,38,20,228,1419,"Bledsoe County, Tennessee",47,007,47007
39522.0,1246.0,825.0,40.0,0,15098,16192,5872,3672,3551,121,10320,8143,7576,567,16192,39803,0.4894,39.9,20970,39155,34469,141,68,58,100,4319,"Campbell County, Tennessee",47,013,47013
14014.0,875.0,143.0,5.0,0,6380,5488,1781,1287,1239,48,3707,2854,2664,190,5488,55330,0.4285,39.8,6132,13997,12488,68,73,1,78,1289,"Cannon County, Tennessee",47,015,47015
8077.0,475.0,131.0,0.0,22,2932,2878,1065,633,614,19,1813,1200,1136,64,2878,42711,0.4846,39.1,4224,7955,7163,24,9,0,19,740,"Houston County, Tennessee",47,083,47083
90995.0,3758.0,2894.0,159.0,87,43748,34688,10089,6664,6361,303,24599,19677,18265,1412,34688,57170,0.4351,39.7,37677,90866,81110,1100,760,354,1017,6525,"Maury County, Tennessee",47,119,47119
48534.0,3729.0,457.0,425.0,90,18476,18033,6381,4300,4132,168,11652,8900,8454,446,18033,49279,0.4583,41.8,25670,45390,35844,576,694,452,780,7044,"Polk County, Texas",48,373,48373
7086.0,317.0,11.0,1.0,0,2694,2547,1036,703,655,48,1511,1109,1086,23,2547,50076,0.4406,40.7,3732,6981,5774,75,23,8,18,1083,"Refugio County, Texas",48,391,48391
54361.0,3432.0,550.0,21.0,11,21843,20156,7543,5308,4985,323,12613,10375,9714,661,20156,54654,0.4542,41.6,23421,54486,43178,728,728,268,769,8815,"Van Zandt County, Texas",48,467,48467
41466.0,4016.0,570.0,108.0,0,18378,13460,3892,2545,2373,172,9568,7696,7246,450,13460,54152,0.4667,40.1,14889,40074,28677,805,1211,550,1990,6841,"Caldwell County, Texas",48,055,48055
12701.0,687.0,218.0,16.0,3,6089,5180,1752,922,907,15,3428,2554,2345,209,5180,45302,0.4349,39.9,6240,12633,10383,172,216,18,172,1672,"Wilbarger County, Texas",48,487,48487
5590.0,189.0,64.0,0.0,0,2464,1694,438,298,291,7,1256,967,954,13,1694,66610,0.4371,42.4,1977,5593,4818,75,89,21,42,548,"Martin County, Texas",48,317,48317
11989.0,284.0,201.0,24.0,0,5579,5106,1704,999,974,25,3402,2609,2463,146,5106,45930,0.4238,40.0,6394,11976,10615,58,38,10,9,1246,"Linn County, Missouri",29,115,29115
39487.0,1026.0,525.0,102.0,64,16210,15878,5422,3329,3141,188,10456,8050,7527,523,15878,38357,0.4617,38.6,18281,39706,33897,152,186,82,30,5359,"Howell County, Missouri",29,091,29091
52897.0,4437.0,2664.0,510.0,41,26742,19864,4498,2954,2870,84,15366,12414,10171,2243,19864,55273,0.3975,38.0,22280,49542,43829,568,601,26,222,4296,"Johnson County, Missouri",29,101,29101
34882.0,1089.0,291.0,64.0,0,15395,14112,4398,2852,2743,109,9714,8054,7533,521,14112,47257,0.4158,40.8,16022,35119,30999,238,92,0,25,3765,"Laclede County, Missouri",29,105,29105
8759.0,657.0,105.0,52.0,6,3716,3762,1247,826,792,34,2515,1859,1658,201,3762,47569,0.4424,38.2,4606,8700,7567,44,0,23,72,994,"Maries County, Missouri",29,125,29125
43825.0,3181.0,1288.0,344.0,61,18739,17981,4986,2852,2738,114,12995,9834,8325,1509,17981,44154,0.4848,36.6,20287,43883,38230,614,1578,34,127,3300,"Phelps County, Missouri",29,161,29161
99784.0,6179.0,4386.0,621.0,234,53441,39305,9879,6505,6035,470,29426,22213,19950,2263,39305,80393,0.4261,40.0,41776,99737,89026,2801,2111,258,370,5171,"Platte County, Missouri",29,165,29165
66031.0,3543.0,879.0,131.0,0,26979,24898,7258,4330,4196,134,17640,13603,12255,1348,24898,46466,0.4185,38.7,30065,59966,54145,272,168,41,142,5198,"St. Francois County, Missouri",29,187,29187
304193.0,14057.0,11417.0,2371.0,13466,153311,141952,31702,15035,13644,1391,110250,62583,50680,11903,141952,43896,0.5048,38.7,176729,303603,253186,8363,9230,1274,3262,28288,"St. Louis city, Missouri",29,510,29510
17331.0,738.0,234.0,6.0,0,8203,6763,2407,1562,1533,29,4356,3444,3210,234,6763,58772,0.4115,40.3,7338,17306,16097,165,49,0,2,993,"Andrew County, Missouri",29,003,29003
42184.0,1258.0,1112.0,3.0,239,17170,16390,5585,3258,3151,107,10805,8621,7846,775,16390,39915,0.471,39.3,19858,41998,36559,254,192,2,110,4881,"Butler County, Missouri",29,023,29023
8595.0,212.0,268.0,9.0,1,3571,3503,1293,787,752,35,2210,1769,1692,77,3503,50830,0.4344,40.7,4654,8692,7605,73,11,23,41,939,"Carroll County, Missouri",29,033,29033
8194.0,429.0,104.0,14.0,0,3497,3035,1166,750,726,24,1869,1527,1411,116,3035,51679,0.4299,39.9,4194,8099,6692,18,36,3,2,1348,"Daviess County, Missouri",29,061,29061
4370.0,143.0,81.0,0.0,4,2000,2022,807,416,402,14,1215,946,848,98,2022,49524,0.4105,40.2,2792,4320,3938,8,8,11,0,355,"Holt County, Missouri",29,087,29087
28323.0,1317.0,550.0,37.0,11,12813,11565,3435,1965,1895,70,8130,6142,5534,608,11565,48784,0.4421,38.3,13036,27924,25409,126,110,0,4,2275,"Marion County, Missouri",29,127,29127
13407.0,504.0,81.0,11.0,19,6907,5120,1549,1025,1024,1,3571,2947,2709,238,5120,61687,0.403,39.7,6629,13481,12838,4,4,7,0,628,"Osage County, Missouri",29,151,29151
13494.0,451.0,184.0,14.0,0,5080,5059,1988,1183,1105,78,3071,2488,2274,214,5059,34971,0.4357,38.2,6638,13515,11479,80,0,0,21,1935,"Ripley County, Missouri",29,181,29181
34002.0,2605.0,277.0,66.0,30,15657,12654,4016,2934,2703,231,8638,7093,6693,400,12654,60125,0.4235,39.4,15502,34267,31343,344,103,62,13,2402,"Warren County, Missouri",29,219,29219
24675.0,1266.0,215.0,9.0,29,8819,9231,2934,1734,1674,60,6297,5245,4919,326,9231,41483,0.4533,38.4,11070,23758,20742,25,48,0,0,2943,"Washington County, Missouri",29,221,29221
84296.0,4522.0,1853.0,107.0,7,40291,31645,8931,5778,5621,157,22714,18679,17176,1503,31645,60645,0.4107,39.1,34213,85212,76819,677,658,82,324,6652,"Christian County, Missouri",29,043,29043
12422.0,1210.0,304.0,63.0,1,4305,3807,1263,695,646,49,2544,1937,1773,164,3807,55918,0.3919,41.2,4325,9190,8441,37,30,0,4,678,"DeKalb County, Missouri",29,063,29063
8424.0,221.0,225.0,3.0,5,3591,3429,1254,691,637,54,2175,1718,1601,117,3429,42917,0.401,39.2,4385,8306,7193,59,25,0,45,984,"Harrison County, Missouri",29,081,29081
32242.0,1546.0,696.0,102.0,1,15262,13050,4188,2454,2392,62,8862,7301,6548,753,13050,58766,0.4204,39.9,14807,32102,29007,233,121,35,42,2664,"Lafayette County, Missouri",29,107,29107
25134.0,1879.0,972.0,236.0,26,10552,9258,2465,1250,1229,21,6793,4898,3775,1123,9258,41929,0.5137,35.9,11542,25075,22232,160,708,22,138,1815,"Adair County, Missouri",29,001,29001
4770.0,91.0,260.0,8.0,0,2002,1768,616,382,364,18,1152,845,823,22,1768,50085,0.5092,42.2,2369,4813,3185,16,0,0,0,1612,"Scotland County, Missouri",29,199,29199
6178.0,93.0,76.0,5.0,0,2680,2128,703,384,384,0,1425,1022,950,72,2128,46481,0.4222,40.0,3337,6048,4880,226,211,62,49,620,"Sullivan County, Missouri",29,211,29211
6703.0,95.0,170.0,53.0,1,3122,2657,910,511,501,10,1747,1347,1249,98,2657,48909,0.4638,41.6,3497,6674,5664,33,39,14,0,924,"Clark County, Missouri",29,045,29045
118446.0,2912.0,3804.0,256.0,189,55485,45759,12950,7418,7057,361,32809,25564,23097,2467,45759,48357,0.4367,38.5,51322,119041,100363,1406,1627,240,1975,13430,"Jasper County, Missouri",29,097,29097
9853.0,431.0,406.0,16.0,13,4291,3752,1302,685,679,6,2450,1963,1824,139,3752,45988,0.429,39.0,4550,9763,8745,22,42,13,0,941,"Lewis County, Missouri",29,111,29111
22490.0,671.0,731.0,44.0,5,9287,8259,2287,1637,1596,41,5972,5051,4668,383,8259,41643,0.4233,41.5,9983,22611,17327,253,793,16,730,3492,"McDonald County, Missouri",29,119,29119
19045.0,761.0,428.0,48.0,20,9318,7576,2248,1407,1367,40,5328,4342,3960,382,7576,55863,0.3927,40.2,8748,18857,17401,144,116,8,15,1173,"Perry County, Missouri",29,157,29157
31415.0,1742.0,939.0,101.0,11,14207,11712,3638,2300,2197,103,8074,6867,5990,877,11712,45660,0.436,37.3,13573,31294,26862,180,79,62,14,4097,"Polk County, Missouri",29,167,29167
22555.0,879.0,394.0,125.0,57,10735,8868,2746,1784,1681,103,6122,4963,4591,372,8868,61957,0.4005,40.4,10078,22621,20124,105,67,0,2,2323,"Ray County, Missouri",29,177,29177
16199.0,614.0,341.0,54.0,34,6985,6369,1750,1031,962,69,4619,3382,3038,344,6369,49321,0.4258,38.2,7348,16311,15052,94,81,0,4,1080,"Hill County, Montana",30,041,30041
5648.0,292.0,251.0,72.0,22,2560,2274,807,497,491,6,1467,1118,1062,56,2274,42298,0.4388,38.7,2922,5688,4980,43,43,8,15,599,"Chouteau County, Montana",30,015,30015
19407.0,536.0,864.0,89.0,48,6733,8122,3561,2255,2121,134,4561,3250,2991,259,8122,40140,0.4744,36.4,11591,19361,16693,393,198,34,56,1987,"Lincoln County, Montana",30,053,30053
16168.0,352.0,525.0,46.0,90,8209,7782,2643,1551,1445,106,5139,3602,3040,562,7782,53068,0.4729,39.2,9599,16255,14224,209,151,19,39,1613,"Park County, Montana",30,067,30067
657.0,44.0,15.0,0.0,0,330,351,133,82,82,0,218,145,137,8,351,43047,0.4722,40.4,469,668,614,21,0,0,0,33,"Treasure County, Montana",30,103,30103
6555.0,113.0,172.0,11.0,30,2435,2366,780,457,452,5,1586,1175,1106,69,2366,41279,0.4374,39.7,2841,6615,5570,45,3,0,0,997,"Blaine County, Montana",30,005,30005
3642.0,243.0,96.0,27.0,92,1560,1566,733,507,493,14,833,530,518,12,1566,49886,0.4162,40.1,2209,3648,3403,11,21,0,0,213,"Sweet Grass County, Montana",30,097,30097
5991.0,343.0,159.0,9.0,16,2623,2464,996,530,521,9,1468,1153,1110,43,2464,55000,0.4167,39.3,2919,5987,5298,40,16,3,9,621,"Teton County, Montana",30,099,30099
1244.0,11.0,3.0,0.0,0,564,518,231,125,117,8,287,247,229,18,518,43625,0.4703,42.6,690,1234,1131,30,24,0,0,49,"Prairie County, Montana",30,079,30079
13509.0,490.0,299.0,61.0,0,4904,4163,1267,662,662,0,2896,2082,1898,184,4163,36045,0.4796,38.6,5397,13627,8363,40,80,11,40,5093,"Glacier County, Montana",30,035,30035
2904.0,17.0,114.0,2.0,2,1556,1334,342,183,183,0,992,673,588,85,1334,64545,0.4112,44.5,1534,2834,2462,0,71,0,0,301,"Fallon County, Montana",30,025,30025
726.0,39.0,25.0,0.0,0,353,351,136,89,86,3,215,136,131,5,351,43875,0.5104,41.2,478,728,642,12,0,3,0,71,"Golden Valley County, Montana",30,037,30037
34499.0,1718.0,905.0,235.0,148,15733,14960,4862,2464,2357,107,10098,6559,5633,926,14960,45718,0.471,37.5,17242,34149,31467,361,527,47,22,1725,"Silver Bow County, Montana",30,093,30093
9405.0,470.0,136.0,15.0,98,4415,3761,1318,930,918,12,2443,1829,1698,131,3761,64645,0.385,38.9,4866,9417,8747,24,49,23,2,572,"Stillwater County, Montana",30,095,30095
11817.0,814.0,441.0,0.0,35,5370,4484,1554,1140,1079,61,2930,2298,2176,122,4484,69646,0.3998,38.2,5112,11728,10900,63,53,0,0,712,"Jefferson County, Montana",30,043,30043
3284.0,150.0,139.0,2.0,2,1124,1308,583,374,314,60,725,445,404,41,1308,49881,0.4972,37.3,2832,3276,3034,9,7,0,0,226,"Granite County, Montana",30,039,30039
2104.0,38.0,13.0,1.0,20,916,792,318,165,155,10,474,359,334,25,792,39655,0.4406,45.7,1173,2111,1813,12,5,0,44,237,"Wheatland County, Montana",30,107,30107
8226.0,390.0,285.0,192.0,67,3932,3570,1687,944,897,47,1883,1367,1202,165,3570,54107,0.4333,38.7,7002,8245,7195,49,230,2,29,740,"Madison County, Montana",30,057,30057
3460.0,90.0,106.0,8.0,17,1707,1639,532,354,336,18,1107,715,567,148,1639,55521,0.4567,41.4,2161,3441,3060,28,44,0,1,308,"Sheridan County, Montana",30,091,30091
1314.0,24.0,59.0,0.0,0,637,628,222,149,148,1,406,275,254,21,628,48000,0.4491,44.7,784,1307,1040,0,0,0,0,267,"Carter County, Montana",30,011,30011
13289.0,322.0,137.0,0.0,30,4747,3609,1063,754,741,13,2546,2145,1988,157,3609,49859,0.4293,39.5,4732,13266,8881,29,74,0,27,4255,"Big Horn County, Montana",30,003,30003
29697.0,1597.0,1146.0,6.0,58,12254,11802,4420,3063,2859,204,7382,5718,5150,568,11802,48829,0.4535,37.9,16886,29820,25087,241,248,44,46,4154,"Lake County, Montana",30,047,30047
66962.0,2299.0,2576.0,184.0,130,34490,27893,8141,4991,4626,365,19752,14355,12593,1762,27893,65791,0.421,37.7,31621,67138,62524,429,339,24,0,3822,"Lewis and Clark County, Montana",30,049,30049
5932.0,238.0,217.0,16.0,0,2486,2103,844,490,481,9,1259,981,933,48,2103,51151,0.4346,39.7,2692,5927,5344,41,36,1,0,505,"Pondera County, Montana",30,073,30073
157327.0,3617.0,4759.0,432.0,414,79902,66385,18631,10835,10257,578,47754,35746,31090,4656,66385,61264,0.454,39.0,71184,156854,142621,1877,1096,62,255,10943,"Yellowstone County, Montana",30,111,30111
116188.0,4751.0,5643.0,589.0,1302,63604,49313,12770,7718,7305,413,36543,26303,20512,5791,49313,54062,0.4729,36.9,53955,116660,105577,1682,1540,197,75,7589,"Missoula County, Montana",30,063,30063
8464.0,266.0,0.0,0.0,0,3549,2617,712,514,460,54,1905,1556,1525,31,2617,70005,0.3768,45.8,3037,8631,5310,303,612,80,1264,1062,"Yoakum County, Texas",48,501,48501
33378.0,2381.0,381.0,123.0,57,13882,10933,3025,1876,1812,64,7908,6229,6065,164,10933,48384,0.4301,40.5,13401,32100,23732,777,1081,172,1329,5009,"Hale County, Texas",48,189,48189
24936.0,667.0,146.0,8.0,0,9592,9293,3027,1866,1860,6,6266,5007,4896,111,9293,42522,0.4653,40.9,12290,25178,18875,380,454,35,1222,4212,"Shelby County, Texas",48,419,48419
12031.0,403.0,114.0,0.0,0,4954,4963,1941,1125,1113,12,3022,2247,2171,76,4963,39142,0.4449,39.4,6951,11974,10034,114,106,0,97,1623,"Red River County, Texas",48,387,48387
10217.0,324.0,34.0,8.0,12,4398,3896,1510,915,881,34,2386,1937,1810,127,3896,44940,0.4417,41.5,5249,10065,8461,126,112,84,91,1191,"Runnels County, Texas",48,399,48399
3721.0,204.0,72.0,32.0,0,1737,1412,486,291,291,0,926,722,705,17,1412,54306,0.4044,44.0,2026,3808,2822,140,168,51,158,469,"Sutton County, Texas",48,435,48435
116708.0,5325.0,4073.0,403.0,118,57043,43314,12082,7610,7196,414,31232,22827,20473,2354,43314,53903,0.4684,41.1,48598,113076,92271,2910,2437,566,1353,13539,"Tom Green County, Texas",48,451,48451
90990.0,3222.0,884.0,419.0,439,41594,32255,9977,6578,6155,423,22278,17549,16257,1292,32255,56834,0.468,40.4,37149,91105,72116,2037,1630,374,2186,12762,"Victoria County, Texas",48,469,48469
41158.0,1502.0,64.0,125.0,20,17687,15199,5059,3050,2914,136,10140,7937,7641,296,15199,48310,0.4759,41.8,17633,41228,31482,700,1315,363,1694,5674,"Wharton County, Texas",48,481,48481
129739.0,5692.0,6421.0,1001.0,349,60792,48356,13610,7643,7351,292,34746,25713,23113,2600,48356,48650,0.4581,39.0,56057,117060,94904,2766,2910,536,1659,14285,"Wichita County, Texas",48,485,48485
588.0,19.0,3.0,0.0,0,230,227,102,75,70,5,125,96,96,0,227,72188,0.3924,41.5,405,613,560,19,0,0,0,34,"Borden County, Texas",48,033,48033
9942.0,496.0,169.0,39.0,11,3700,4715,1951,1087,1066,21,2764,1956,1846,110,4715,37662,0.5129,39.9,6413,9886,8590,55,96,25,34,1086,"Marion County, Texas",48,315,48315
57213.0,1301.0,245.0,883.0,42,21352,16286,4675,3469,3346,123,11611,10525,10100,425,16286,39625,0.4493,39.8,18387,57962,28358,5302,6275,1473,5169,11385,"Maverick County, Texas",48,323,48323
129418.0,6929.0,2390.0,517.0,196,59942,48454,15777,9859,9422,437,32677,24771,23193,1578,48454,54815,0.4467,40.0,55971,129692,103059,1797,2213,411,3726,18486,"Grayson County, Texas",48,181,48181
12033.0,1073.0,105.0,67.0,0,4396,3752,1473,938,908,30,2279,1690,1539,151,3752,53848,0.4507,40.6,6264,10723,8679,67,62,55,173,1687,"Live Oak County, Texas",48,297,48297
28336.0,1754.0,426.0,89.0,39,11553,10255,3687,2387,2276,111,6568,5202,4620,582,10255,50154,0.4554,40.4,15504,28298,21671,655,455,150,751,4616,"Palo Pinto County, Texas",48,363,48363
15427.0,729.0,146.0,873.0,9,5245,4282,1446,815,785,30,2836,2131,2030,101,4282,56127,0.5306,41.6,5995,12633,10476,188,153,94,587,1135,"Karnes County, Texas",48,255,48255
20161.0,1268.0,76.0,13.0,8,7678,7048,2631,1621,1568,53,4417,3700,3427,273,7048,55357,0.5146,43.0,9252,18413,15596,100,94,35,353,2235,"DeWitt County, Texas",48,123,48123
13680.0,636.0,236.0,0.0,0,5802,5367,2078,1218,1186,32,3289,2328,2222,106,5367,48651,0.4479,41.2,6720,13769,11145,45,112,0,55,2412,"Callahan County, Texas",48,059,48059
29732.0,547.0,234.0,3.0,0,11335,11934,4810,2900,2790,110,7124,5645,5466,179,11934,44848,0.4331,39.7,14623,29683,25394,74,135,159,234,3687,"Cass County, Texas",48,067,48067
121689.0,7705.0,1560.0,223.0,44,54346,45460,12788,8023,7756,267,32672,24501,21871,2630,45460,50180,0.4685,39.6,52069,121085,93179,2289,3259,1006,4533,16819,"Gregg County, Texas",48,183,48183
14011.0,1065.0,94.0,21.0,0,4846,4269,1538,887,871,16,2731,2052,1945,107,4269,52664,0.4491,42.4,5290,11105,8413,231,747,13,266,1435,"Madison County, Texas",48,313,48313
300461.0,21789.0,6670.0,1667.0,1199,147866,113488,26313,16254,15485,769,87175,65395,54507,10888,113488,52429,0.4791,38.5,127070,300582,248249,5539,7783,946,3721,34344,"Lubbock County, Texas",48,303,48303
122248.0,10654.0,2294.0,213.0,92,57844,38015,9735,6841,6543,298,28280,24279,23244,1035,38015,70107,0.4092,40.3,41433,122679,99793,3054,3002,620,3090,13120,"Kaufman County, Texas",48,257,48257
43335.0,3251.0,919.0,90.0,81,20354,14253,4988,3593,3546,47,9265,7804,7484,320,14253,84747,0.489,39.7,16089,43339,37101,955,1068,174,685,3356,"Kendall County, Texas",48,259,48259
5779.0,168.0,23.0,0.0,34,2415,2271,750,446,440,6,1521,1201,1155,46,2271,50580,0.4073,42.0,2972,5766,4228,60,240,56,145,1037,"Floyd County, Texas",48,153,48153
7100.0,184.0,135.0,0.0,0,3101,2054,622,353,353,0,1432,1166,1086,80,2054,52273,0.4025,38.9,2515,6887,4877,234,318,106,427,925,"Bailey County, Texas",48,017,48017
40792.0,1943.0,797.0,24.0,36,18871,14069,3273,2090,2046,44,10796,9456,9261,195,14069,91141,0.424,41.6,15771,41023,34812,839,723,220,1380,3049,"Chambers County, Texas",48,071,48071
342297.0,15368.0,19639.0,4672.0,731,156345,122689,25547,17014,16476,538,97142,73919,68498,5421,122689,54884,0.4372,41.0,139978,327097,267378,11623,8439,1623,5777,32257,"Bell County, Texas",48,027,48027
415855.0,4825.0,1973.0,2206.0,1126,159411,124605,38630,27049,26390,659,85975,73777,71358,2419,124605,38758,0.4833,38.2,151096,419669,250112,24936,25457,7092,39073,72999,"Cameron County, Texas",48,061,48061
18464.0,421.0,258.0,16.0,83,8176,6145,1486,877,867,10,4659,3858,3655,203,6145,49701,0.3949,42.9,7069,18532,12814,627,1448,147,925,2571,"Deaf Smith County, Texas",48,117,48117
822677.0,10657.0,23946.0,8816.0,4982,361986,268310,70389,48308,46712,1596,197921,155968,148631,7337,268310,46871,0.4613,39.1,296101,811690,509357,77879,59607,16769,44407,103671,"El Paso County, Texas",48,141,48141
7352.0,431.0,88.0,230.0,0,2584,2269,882,440,421,19,1387,1254,1208,46,2269,50151,0.5508,39.6,3056,6460,5112,62,69,2,71,1144,"La Salle County, Texas",48,283,48283
894.0,19.0,0.0,0.0,0,357,418,237,128,122,6,181,134,131,3,418,43208,0.4328,38.7,785,896,803,0,8,7,3,75,"Terrell County, Texas",48,443,48443
21344.0,2207.0,329.0,17.0,0,6457,7100,3027,1902,1834,68,4073,3083,2940,143,7100,44497,0.4263,40.0,10868,18863,15440,119,125,56,221,2902,"Tyler County, Texas",48,457,48457
5274.0,253.0,41.0,0.0,0,2449,2183,707,432,421,11,1476,1178,1097,81,2183,49315,0.4379,43.5,2721,5272,4033,52,181,16,180,810,"Wheeler County, Texas",48,483,48483
8631.0,496.0,20.0,20.0,14,4361,3452,1243,778,758,20,2209,1745,1644,101,3452,63835,0.4654,40.5,4158,8655,7404,21,111,28,130,961,"Archer County, Texas",48,009,48009
9199.0,764.0,256.0,18.0,0,4365,4088,1494,954,900,54,2594,1619,1333,286,4088,47080,0.4443,42.3,5532,9145,7226,198,260,53,60,1348,"Brewster County, Texas",48,043,48043
842521.0,11751.0,5857.0,4757.0,1137,321731,238345,62834,46138,44858,1280,175511,153502,148176,5326,238345,40014,0.4867,39.1,276307,846855,481916,47893,60163,15637,102767,138479,"Hidalgo County, Texas",48,215,48215
225012.0,10144.0,3540.0,965.0,360,100354,77678,24593,16011,15536,475,53085,41754,38383,3371,77678,56810,0.4667,40.0,90418,225116,178455,5277,4641,1767,7218,27758,"Smith County, Texas",48,423,48423
3432.0,38.0,3.0,0.0,0,1738,1354,312,184,184,0,1042,764,764,0,1354,47386,0.4284,46.0,1819,3418,2599,82,20,28,148,541,"Crockett County, Texas",48,105,48105
5648.0,745.0,96.0,102.0,0,2163,2146,835,503,489,14,1311,965,934,31,2146,40313,0.4223,41.5,3469,5271,4052,26,94,52,52,995,"Haskell County, Texas",48,207,48207
35982.0,2169.0,1077.0,493.0,25,14115,11064,3143,1619,1512,107,7921,6071,5679,392,11064,54208,0.4696,40.6,13180,31769,25520,490,360,93,202,5104,"Howard County, Texas",48,227,48227
4801.0,176.0,48.0,6.0,0,1909,1790,898,503,486,17,892,683,674,9,1790,49306,0.4953,38.0,2882,4715,3715,60,100,99,90,651,"Mills County, Texas",48,333,48333
19272.0,1041.0,263.0,21.0,67,7992,7800,2949,1806,1741,65,4851,3762,3438,324,7800,51765,0.4554,41.8,10269,19189,15231,154,212,137,410,3045,"Montague County, Texas",48,337,48337
23099.0,1223.0,181.0,6.0,2,9458,8637,3054,2026,1979,47,5583,4488,4253,235,8637,52982,0.4493,42.5,11280,23097,18821,90,232,47,486,3421,"Panola County, Texas",48,365,48365
10265.0,451.0,431.0,0.0,0,2969,4311,2141,1293,1267,26,2170,1736,1673,63,4311,34992,0.4969,39.1,8306,10382,8969,92,22,0,11,1288,"Sabine County, Texas",48,403,48403
3035.0,50.0,20.0,0.0,0,1511,1019,279,168,161,7,740,620,593,27,1019,51926,0.5065,45.6,1416,3030,2135,120,150,8,246,371,"Sherman County, Texas",48,421,48421
7375.0,749.0,86.0,40.0,27,2651,2505,964,595,588,7,1541,1217,1129,88,2505,39771,0.4793,42.5,3196,6783,5130,71,215,130,604,633,"Swisher County, Texas",48,437,48437
93158.0,5982.0,1131.0,571.0,70,40262,33189,10092,6667,6395,272,23097,17858,16366,1492,33189,54959,0.4402,39.5,37798,93354,74382,1820,1959,565,2010,12618,"Hunt County, Texas",48,231,48231
12706.0,980.0,159.0,21.0,19,5293,4605,1656,1082,1047,35,2949,2462,2267,195,4605,48207,0.4345,41.2,5795,12831,9842,211,603,58,425,1692,"Camp County, Texas",48,063,48063
5438.0,125.0,176.0,0.0,9,2333,1838,500,351,347,4,1338,1013,1013,0,1838,38000,0.4383,43.9,2349,5441,3182,222,779,93,441,724,"Hansford County, Texas",48,195,48195
157316.0,7614.0,4933.0,580.0,104,75184,54110,14719,10413,9870,543,39391,32988,31497,1491,54110,74496,0.3992,40.8,58406,156604,130470,4907,2976,1123,2276,14852,"Guadalupe County, Texas",48,187,48187
10285.0,572.0,217.0,24.0,0,4376,4105,1531,996,939,57,2574,2040,1916,124,4105,55989,0.4279,41.1,5257,10313,8848,60,106,34,180,1085,"Clay County, Texas",48,077,48077
5600.0,753.0,7.0,4.0,0,1992,1678,540,331,314,17,1138,922,894,28,1678,58298,0.372,45.9,1939,4130,3199,118,164,39,158,452,"Hartley County, Texas",48,205,48205
3686.0,82.0,6.0,129.0,0,1638,1084,205,144,144,0,879,729,682,47,1084,74868,0.3476,44.9,1280,3731,2561,157,188,65,258,502,"Reagan County, Texas",48,383,48383
35319.0,2215.0,487.0,167.0,4,15008,12992,4896,3069,2940,129,8096,6581,6158,423,12992,53307,0.4401,40.2,16337,35029,27968,864,800,226,670,4501,"Hill County, Texas",48,217,48217
23084.0,1308.0,181.0,32.0,22,8960,8377,2888,1849,1803,46,5489,4248,4049,199,8377,44418,0.448,41.2,10731,22585,16999,469,829,168,696,3424,"Limestone County, Texas",48,293,48293
64571.0,5301.0,881.0,81.0,58,27223,23757,6675,4010,3852,158,17082,13255,11294,1961,23757,44847,0.4943,37.9,28442,64576,50632,1412,1203,182,2331,8816,"Nacogdoches County, Texas",48,347,48347
9537.0,432.0,218.0,24.0,23,4354,3203,933,564,542,22,2270,1841,1770,71,3203,55359,0.413,43.3,3805,9638,6338,547,835,100,593,1225,"Parmer County, Texas",48,369,48369
132274.0,6962.0,2598.0,789.0,155,61568,44263,13312,9064,8813,251,30951,26162,25013,1149,44263,77503,0.4328,40.5,50045,132401,109531,2150,1492,310,2748,16170,"Parker County, Texas",48,367,48367
42036.0,897.0,1960.0,46.0,18,17726,17354,7202,5025,4826,199,10152,7655,7111,544,17354,53054,0.458,37.2,19816,42324,36997,490,218,75,57,4487,"Ravalli County, Montana",30,081,30081
7395.0,234.0,90.0,0.0,8,3533,3386,1118,667,646,21,2268,1743,1545,198,3386,53162,0.3997,40.5,4879,7375,6652,86,15,5,9,608,"Valley County, Montana",30,105,30105
80330.0,2753.0,3199.0,410.0,296,38629,34329,10681,5989,5764,225,23648,17676,15714,1962,34329,49913,0.4724,38.4,38857,78229,70559,1028,511,71,47,6013,"Cascade County, Montana",30,013,30013
11091.0,344.0,135.0,35.0,29,5396,4912,1802,931,902,29,3110,2269,2069,200,4912,50540,0.4667,39.1,5896,11038,9947,6,75,0,26,984,"Fergus County, Montana",30,027,30027
1012.0,3.0,22.0,0.0,2,548,438,167,100,98,2,271,220,206,14,438,42000,0.4716,42.8,814,1036,917,0,0,0,0,119,"Garfield County, Montana",30,033,30033
4209.0,127.0,273.0,3.0,5,1576,1786,770,471,471,0,1016,646,608,38,1786,41705,0.4474,38.1,2504,4161,3781,57,4,4,8,307,"Mineral County, Montana",30,061,30061
447.0,37.0,0.0,0.0,0,218,204,76,55,33,22,128,94,88,6,204,51250,0.415,49.4,302,453,394,20,0,0,0,39,"Petroleum County, Montana",30,069,30069
6805.0,663.0,121.0,0.0,2,2516,2426,941,625,602,23,1485,1148,1049,99,2426,54667,0.4208,36.7,3203,5245,4883,9,19,2,0,332,"Powell County, Montana",30,077,30077
11586.0,362.0,434.0,7.0,0,4246,5036,2410,1485,1322,163,2626,1923,1720,203,5036,40823,0.4625,38.0,6762,11565,10042,105,93,9,10,1306,"Sanders County, Montana",30,089,30089
1105.0,5.0,67.0,0.0,0,557,498,182,98,98,0,316,254,251,3,498,53958,0.3241,43.5,601,1102,930,19,12,0,0,141,"Wibaux County, Montana",30,109,30109
106859.0,3504.0,6879.0,450.0,283,60638,43777,9208,6274,5933,341,34569,25694,19223,6471,43777,66397,0.4647,37.8,49478,107687,96177,1533,1596,244,209,7928,"Gallatin County, Montana",30,031,30031
1859.0,102.0,176.0,7.0,0,908,702,296,178,157,21,406,295,266,29,702,46607,0.3997,42.5,1368,1864,1569,18,34,0,7,236,"Meagher County, Montana",30,059,30059
10549.0,306.0,163.0,21.0,39,5162,4524,1678,1054,1011,43,2846,1913,1727,186,4524,58707,0.4031,38.9,6570,10475,9659,73,24,5,0,714,"Carbon County, Montana",30,009,30009
9339.0,632.0,414.0,39.0,0,4533,3992,1375,821,812,9,2617,1662,1474,188,3992,43201,0.4927,38.5,5344,9273,8330,59,130,0,19,735,"Beaverhead County, Montana",30,001,30001
98780.0,2118.0,4021.0,241.0,300,47648,38773,12805,8093,7674,419,25968,19198,17594,1604,38773,56182,0.4581,38.0,48785,99293,88494,1520,626,55,278,8320,"Flathead County, Montana",30,029,30029
4714.0,311.0,173.0,0.0,0,1793,2181,853,509,492,17,1328,991,899,92,2181,43274,0.4173,38.6,2733,4735,4329,70,13,0,2,321,"Musselshell County, Montana",30,065,30065
3365.0,112.0,55.0,0.0,10,1630,1521,565,339,324,15,956,672,591,81,1521,49835,0.4145,41.3,2354,3366,3100,17,23,0,0,226,"Harlan County, Nebraska",31,083,31083
13618.0,944.0,323.0,20.0,4,6708,5656,1761,1164,1149,15,3895,2768,2528,240,5656,60298,0.4586,39.8,6327,13032,11972,77,64,0,102,817,"York County, Nebraska",31,185,31185
48626.0,3246.0,1185.0,178.0,58,26928,19062,4824,2673,2543,130,14238,10833,9225,1608,19062,59431,0.4503,38.8,20482,48640,42651,832,826,135,528,3668,"Buffalo County, Nebraska",31,019,31019
10555.0,330.0,118.0,211.0,6,5350,3731,986,514,474,40,2745,2318,1937,381,3731,58872,0.3953,41.6,4205,10586,6637,907,1609,114,758,561,"Colfax County, Nebraska",31,037,31037
2774.0,88.0,77.0,4.0,0,1327,1243,500,277,266,11,743,503,462,41,1243,49962,0.4581,38.0,1746,2777,2482,2,2,0,0,291,"Hitchcock County, Nebraska",31,087,31087
32764.0,1057.0,549.0,127.0,17,17120,12947,3889,2172,2115,57,9058,6951,6422,529,12947,62305,0.4138,39.6,13784,32893,27497,1228,1169,126,901,1972,"Platte County, Nebraska",31,141,31141
5159.0,216.0,31.0,6.0,5,2597,2052,743,458,441,17,1309,1058,1008,50,2052,67719,0.368,40.7,2751,5143,4460,28,37,37,56,525,"Polk County, Nebraska",31,143,31143
10851.0,290.0,166.0,0.0,4,4972,4743,1431,642,626,16,3312,2472,2297,175,4743,54004,0.3899,41.3,5443,10803,9636,52,377,26,15,697,"Box Butte County, Nebraska",31,013,31013
3000.0,101.0,120.0,57.0,0,1503,1387,579,347,320,27,808,524,487,37,1387,43098,0.4843,40.6,1893,2972,2553,10,47,0,21,341,"Brown County, Nebraska",31,017,31017
5191.0,160.0,251.0,5.0,17,2652,2273,941,516,492,24,1332,965,880,85,2273,45371,0.481,41.9,2904,5178,4497,29,11,28,22,591,"Sheridan County, Nebraska",31,161,31161
309200.0,12593.0,9679.0,2292.0,2048,170036,124324,30147,17838,17043,795,94177,68841,56679,12162,124324,60527,0.4467,37.6,131099,308643,266397,10414,9584,815,3470,17963,"Lancaster County, Nebraska",31,109,31109
4188.0,101.0,50.0,0.0,0,2190,1867,798,419,404,15,1069,752,713,39,1867,43388,0.4894,40.7,2445,4176,3841,6,48,0,27,254,"Nuckolls County, Nebraska",31,129,31129
713.0,3.0,23.0,0.0,0,392,283,92,76,76,0,191,155,155,0,283,51750,0.4601,45.9,415,722,671,14,7,0,4,26,"Banner County, Nebraska",31,007,31007
2620.0,184.0,52.0,1.0,0,1277,1135,465,254,254,0,670,530,507,23,1135,54659,0.4142,42.5,1576,2630,2357,7,13,0,4,249,"Frontier County, Nebraska",31,063,31063
552589.0,12561.0,16080.0,3457.0,3549,289258,218061,50409,28779,27303,1476,167652,121787,107361,14426,218061,64629,0.4696,38.9,234520,553559,463597,16389,22538,2660,13250,35125,"Douglas County, Nebraska",31,055,31055
7918.0,169.0,140.0,0.0,0,3713,3704,1332,724,694,30,2372,1654,1528,126,3704,47917,0.432,41.4,4408,7816,7099,35,0,0,39,643,"Richardson County, Nebraska",31,147,31147
10042.0,310.0,241.0,19.0,22,5607,4487,1493,842,809,33,2994,2253,1995,258,4487,60387,0.4177,43.4,5252,10015,9224,146,44,0,78,523,"Holt County, Nebraska",31,089,31089
4690.0,144.0,72.0,3.0,0,2294,2128,816,451,439,12,1312,1012,918,94,2128,48838,0.4196,40.9,2706,4670,4230,20,35,8,26,351,"Furnas County, Nebraska",31,065,31065
14106.0,895.0,449.0,8.0,20,6922,5157,1369,770,739,31,3788,2954,2791,163,5157,51502,0.4154,38.6,5858,14025,10777,798,668,112,605,1065,"Saline County, Nebraska",31,151,31151
7060.0,118.0,148.0,10.0,58,2710,2176,635,397,397,0,1541,1278,1204,74,2176,51034,0.451,40.3,2442,7145,5281,19,37,1,44,1763,"Thurston County, Nebraska",31,173,31173
20211.0,999.0,467.0,17.0,55,10302,8185,2549,1571,1515,56,5636,4588,4232,356,8185,71430,0.4024,40.1,8564,20179,18932,47,134,33,0,1033,"Washington County, Nebraska",31,177,31177
5733.0,226.0,111.0,2.0,26,3208,2537,893,429,412,17,1644,1349,1265,84,2537,56651,0.4124,44.0,3252,5731,5307,37,47,0,0,340,"Cherry County, Nebraska",31,031,31031
36181.0,1219.0,823.0,43.0,22,18056,15261,4805,2717,2569,148,10456,8150,7243,907,15261,54085,0.4173,39.5,16778,36103,31004,602,1020,20,860,2597,"Dodge County, Nebraska",31,053,31053
1855.0,66.0,105.0,1.0,1,859,868,338,182,180,2,530,381,341,40,868,43750,0.5025,39.9,1239,1813,1583,3,47,0,0,180,"Garden County, Nebraska",31,069,31069
4751.0,196.0,128.0,0.0,2,2222,1954,661,346,333,13,1293,931,853,78,1954,46194,0.4212,40.9,2441,4621,4019,27,143,31,24,377,"Morrill County, Nebraska",31,123,31123
6913.0,395.0,238.0,11.0,0,3262,2977,988,534,488,46,1989,1456,1337,119,2977,51828,0.432,37.4,3501,6877,6341,54,36,0,14,432,"Nemaha County, Nebraska",31,127,31127
645.0,35.0,51.0,0.0,0,363,277,97,63,63,0,180,147,128,19,277,59432,0.4467,45.0,393,645,622,0,5,0,0,18,"Thomas County, Nebraska",31,171,31171
19839.0,430.0,511.0,146.0,32,10177,7404,2023,1305,1268,37,5381,4731,4116,615,7404,59231,0.3964,40.6,7840,19962,13592,1844,1972,341,1009,1204,"Dakota County, Nebraska",31,043,31043
6271.0,304.0,99.0,21.0,0,3178,2714,1015,576,573,3,1699,1291,1196,95,2714,49912,0.4039,43.0,3331,6275,5794,35,54,0,31,361,"Antelope County, Nebraska",31,003,31003
3749.0,66.0,54.0,28.0,7,1901,1679,556,323,304,19,1123,883,848,35,1679,57009,0.3984,42.9,1979,3716,3248,6,162,0,78,222,"Chase County, Nebraska",31,029,31029
6140.0,294.0,113.0,10.0,5,2962,2539,875,532,501,31,1664,1264,1175,89,2539,57173,0.3937,40.9,3007,6109,5434,58,71,49,71,426,"Clay County, Nebraska",31,035,31035
10701.0,423.0,104.0,18.0,1,5432,4862,1682,1006,976,30,3180,2344,2206,138,4862,52184,0.4923,42.6,5655,10713,9843,88,22,4,100,656,"Custer County, Nebraska",31,041,31041
2955.0,192.0,70.0,0.0,8,1476,1377,528,319,310,9,849,624,568,56,1377,49282,0.4275,41.2,1713,2924,2751,21,6,0,0,146,"Franklin County, Nebraska",31,061,31061
9135.0,431.0,175.0,8.0,0,4790,3713,1145,729,717,12,2568,2106,2003,103,3713,64210,0.373,39.9,4129,9084,8510,38,5,40,22,469,"Hamilton County, Nebraska",31,081,31081
7009.0,272.0,170.0,4.0,4,3382,3302,1224,590,573,17,2078,1377,1257,120,3302,44510,0.4486,41.8,3921,7037,6547,69,26,29,35,331,"Jefferson County, Nebraska",31,095,31095
7974.0,344.0,225.0,13.0,16,4015,3882,1474,848,818,30,2408,1652,1486,166,3882,50735,0.4298,40.7,5476,8013,7173,105,97,12,8,618,"Keith County, Nebraska",31,101,31101
598.0,23.0,4.0,0.0,0,309,294,105,77,77,0,189,131,121,10,294,51000,0.3797,46.2,447,605,574,0,0,0,0,31,"Loup County, Nebraska",31,115,31115
2888.0,43.0,134.0,11.0,1,1435,1228,458,274,267,7,770,586,573,13,1228,65543,0.4564,42.7,1446,2868,2676,30,24,9,10,119,"Perkins County, Nebraska",31,135,31135
20852.0,1087.0,275.0,26.0,0,10875,8501,2692,1555,1485,70,5809,4669,4366,303,8501,68682,0.4004,39.7,9694,20855,19743,145,30,2,32,903,"Saunders County, Nebraska",31,155,31155
35575.0,862.0,1177.0,43.0,23,16765,14732,4722,2547,2465,82,10010,7656,6843,813,14732,49745,0.4517,40.4,16381,35501,31208,508,497,46,295,2947,"Scotts Bluff County, Nebraska",31,157,31157
744.0,10.0,3.0,0.0,0,384,304,117,66,64,2,187,145,134,11,304,56500,0.4214,45.2,505,760,709,2,0,0,0,49,"Keya Paha County, Nebraska",31,103,31103
3587.0,136.0,172.0,14.0,5,1802,1577,626,363,305,58,951,767,717,50,1577,53403,0.4012,40.5,1924,3579,3024,21,48,1,8,477,"Kimball County, Nebraska",31,105,31105
34838.0,1420.0,1108.0,49.0,103,17272,14856,4449,2583,2510,73,10407,7767,7178,589,14856,59795,0.4358,40.1,16802,34858,30768,426,399,41,127,3097,"Lincoln County, Nebraska",31,111,31111
6887.0,330.0,1.0,100.0,0,2410,2543,1180,443,443,0,1363,968,932,36,2543,25098,0.4726,38.9,4121,6975,3295,604,1259,75,848,894,"Presidio County, Texas",48,377,48377
48116.0,1312.0,1359.0,985.0,105,20685,15779,4983,3443,3383,60,10796,8711,8321,390,15779,46147,0.4697,40.2,19138,46047,29915,4365,3462,565,1686,6054,"Val Verde County, Texas",48,465,48465
2131.0,99.0,2.0,1.0,0,985,580,227,147,147,0,353,264,264,0,580,37900,0.3892,41.7,968,2208,1530,114,42,74,69,379,"Culberson County, Texas",48,109,48109
158296.0,7468.0,2899.0,970.0,272,73910,52530,10969,6772,6545,227,41561,32179,29772,2407,52530,62973,0.4516,43.0,58393,159427,111919,5923,8162,1594,6559,25270,"Ector County, Texas",48,135,48135
6049.0,713.0,372.0,316.0,0,1892,1543,569,383,347,36,974,862,830,32,1543,49627,0.4714,40.3,2044,4208,3356,94,133,55,127,443,"Garza County, Texas",48,169,48169
1471.0,92.0,0.0,130.0,0,735,403,89,69,69,0,314,302,287,15,403,78456,0.4746,51.2,522,1510,1070,51,80,6,215,88,"Glasscock County, Texas",48,173,48173
27809.0,1853.0,297.0,21.0,0,10495,9011,3225,2128,2048,80,5786,4681,4412,269,9011,52913,0.49,40.9,11325,24570,20144,445,553,63,661,2704,"Grimes County, Texas",48,185,48185
963927.0,41274.0,28429.0,9782.0,5790,503576,341163,69649,49114,47554,1560,271514,219000,205170,13830,341163,96913,0.43,40.1,363158,971106,706799,86658,76292,8965,33048,59344,"Collin County, Texas",48,085,48085
86440.0,4252.0,1428.0,226.0,99,35888,31035,9513,6323,6111,212,21522,17543,16589,954,31035,50453,0.4369,40.8,36922,85265,64994,2082,2163,182,2750,13094,"Angelina County, Texas",48,005,48005
1592.0,58.0,15.0,3.0,2,640,707,265,106,106,0,442,318,314,4,707,32305,0.4886,38.7,1145,1642,1406,0,41,0,0,195,"Cottle County, Texas",48,101,48101
211453.0,18374.0,3569.0,764.0,655,108267,73437,15719,11094,10664,430,57718,45636,37642,7994,73437,68717,0.4499,38.4,78715,211703,171279,5377,6622,1330,5400,21695,"Hays County, Texas",48,209,48209
356137.0,15546.0,5897.0,949.0,296,167628,121523,28952,19834,19126,708,92571,74325,69755,4570,121523,81447,0.4216,41.2,136285,348786,266213,20984,12643,3531,9675,35740,"Brazoria County, Texas",48,039,48039
3295.0,190.0,133.0,0.0,0,1475,1335,527,268,261,7,808,571,551,20,1335,42961,0.4584,40.4,2153,3271,2754,26,31,8,22,430,"Donley County, Texas",48,129,48129
48876.0,1669.0,605.0,51.0,0,19458,15546,4838,3322,3186,136,10708,9066,8656,410,15546,55366,0.4324,40.8,18467,49097,37903,717,1685,194,795,7803,"Atascosa County, Texas",48,013,48013
14615.0,993.0,218.0,93.0,0,6159,5407,1807,1079,1063,16,3600,2728,2591,137,5407,45537,0.4788,40.9,7076,14724,11453,212,262,37,246,2514,"Nolan County, Texas",48,353,48353
4310.0,331.0,59.0,577.0,0,1159,978,406,255,255,0,572,493,475,18,978,31677,0.4844,42.2,1579,3624,2013,234,415,27,358,577,"Hudspeth County, Texas",48,229,48229
11473.0,490.0,458.0,0.0,1,4901,3978,1091,723,721,2,2887,2309,2101,208,3978,62986,0.4127,43.2,4830,11552,8653,343,347,87,263,1859,"Ward County, Texas",48,475,48475
65841.0,2638.0,1026.0,57.0,0,27772,23292,7503,5105,4642,463,15789,13086,12422,664,23292,52220,0.4785,40.6,28693,65819,53881,1207,954,222,1199,8356,"Harrison County, Texas",48,203,48203
2110.0,45.0,29.0,0.0,0,992,1014,465,238,238,0,549,353,343,10,1014,36395,0.4737,40.0,1851,2074,1317,86,29,0,97,545,"Menard County, Texas",48,327,48327
24924.0,747.0,193.0,0.0,0,11091,9135,3829,2542,2430,112,5306,4352,4106,246,9135,60189,0.4481,40.1,13987,24726,20755,667,594,144,507,2059,"Fayette County, Texas",48,149,48149
541177.0,32443.0,16454.0,4123.0,2347,275549,180160,41889,28365,27420,945,138271,111389,102537,8852,180160,87337,0.3938,39.9,192488,544319,437986,29075,26651,3011,9811,37785,"Williamson County, Texas",48,491,48491
21048.0,868.0,296.0,4.0,30,8705,6929,2341,1473,1439,34,4588,3518,3358,160,6929,52524,0.431,39.2,10643,21239,16568,306,314,164,181,3706,"Hutchinson County, Texas",48,233,48233
12275.0,549.0,82.0,21.0,0,4941,5117,1894,1086,1000,86,3223,2406,2379,27,5117,41359,0.4449,40.3,6040,12218,10050,36,197,37,213,1685,"Morris County, Texas",48,343,48343
82919.0,3147.0,1041.0,60.0,115,37012,31694,9359,5876,5659,217,22335,17728,16509,1219,31694,59399,0.434,40.1,37404,83317,68612,865,628,220,1191,11801,"Orange County, Texas",48,361,48361
7727.0,164.0,140.0,36.0,0,3274,2619,625,373,366,7,1994,1544,1486,58,2619,60366,0.4091,43.1,3044,7767,5587,250,320,128,325,1157,"Winkler County, Texas",48,495,48495
4577545.0,92619.0,73867.0,55475.0,55244,2208486,1605368,338867,228201,219295,8906,1266501,957947,877365,80582,1605368,61705,0.4971,40.3,1768096,4624525,2946148,363395,379899,80952,388679,465452,"Harris County, Texas",48,201,48201
46295.0,2911.0,487.0,148.0,23,20650,16743,6971,4776,4606,170,9772,8094,7675,419,16743,59492,0.4426,38.2,22793,45961,37101,1133,717,568,773,5669,"Burnet County, Texas",48,053,48053
26308.0,1357.0,257.0,211.0,26,11937,10694,5250,3223,3124,99,5444,4236,4073,163,10694,59155,0.4641,39.2,13184,26117,19719,739,592,238,1164,3665,"Gillespie County, Texas",48,171,48171
2568910.0,69696.0,47119.0,24219.0,33258,1282441,928341,197580,125319,119691,5628,730761,534516,479851,54665,928341,59607,0.4982,40.1,1013364,2588571,1674137,154829,215821,34973,237197,271614,"Dallas County, Texas",48,113,48113
770.0,29.0,5.0,0.0,0,308,270,104,76,76,0,166,142,134,8,270,62000,0.4968,46.2,451,774,628,3,5,0,16,122,"McMullen County, Texas",48,311,48311
17876.0,554.0,139.0,28.0,0,7952,7307,2480,1649,1571,78,4827,3799,3607,192,7307,50635,0.4402,41.0,8720,17743,13743,209,341,88,392,2970,"Young County, Texas",48,503,48503
164734.0,6523.0,2078.0,266.0,70,77369,57310,15905,11353,11020,333,41405,34418,32519,1899,57310,64359,0.4098,40.8,62000,164746,133723,2435,2340,494,1804,23950,"Johnson County, Texas",48,251,48251
36080.0,1731.0,273.0,35.0,46,16125,13424,4439,2925,2869,56,8985,7420,6884,536,13424,52078,0.4474,41.9,15381,36013,27869,685,794,195,996,5474,"Hopkins County, Texas",48,223,48223
9980.0,186.0,255.0,59.0,0,4580,3483,779,490,469,21,2704,2246,2147,99,3483,50464,0.4268,40.9,4113,10067,6578,426,934,121,659,1349,"Ochiltree County, Texas",48,357,48357
3661.0,277.0,56.0,61.0,0,1453,1375,474,231,227,4,901,751,735,16,1375,48798,0.4287,42.9,2033,3571,2817,44,110,51,120,429,"Knox County, Texas",48,275,48275
247824.0,11413.0,6008.0,958.0,417,113016,90054,25003,15974,15431,543,65051,50388,44402,5986,90054,49778,0.4732,38.3,101142,246845,198459,4998,7562,1151,7149,27526,"McLennan County, Texas",48,309,48309
3255.0,469.0,56.0,74.0,0,874,912,397,268,251,17,515,363,363,0,912,47500,0.466,42.4,1665,2195,1887,16,13,7,21,251,"Concho County, Texas",48,095,48095
1918.0,87.0,22.0,1.0,0,842,789,444,227,227,0,345,218,218,0,789,40766,0.4648,36.0,1728,1906,1465,44,22,20,26,329,"Edwards County, Texas",48,137,48137
18059.0,1045.0,214.0,106.0,18,6915,6492,2608,1514,1453,61,3884,2487,2411,76,6492,37276,0.5381,39.2,10386,18010,14299,310,298,37,189,2877,"Eastland County, Texas",48,133,48133
2241.0,46.0,51.0,43.0,0,751,1054,492,381,379,2,562,261,229,32,1054,53088,0.3305,39.9,1913,2177,1358,223,227,0,18,351,"Jeff Davis County, Texas",48,243,48243
5103.0,223.0,0.0,0.0,15,1863,1626,542,308,305,3,1084,906,874,32,1626,33382,0.4708,38.2,2468,5200,4014,27,41,13,114,991,"Jim Hogg County, Texas",48,247,48247
564050.0,25583.0,11022.0,4355.0,2448,267446,198649,50292,35436,33723,1713,148357,121932,114741,7191,198649,80902,0.4761,40.7,216836,569445,439324,22729,27164,4530,22760,52938,"Montgomery County, Texas",48,339,48339
10352.0,161.0,12.0,19.0,17,3330,3148,1261,730,724,6,1887,1590,1530,60,3148,27161,0.4783,38.5,4418,10326,7818,288,94,132,258,1736,"Dimmit County, Texas",48,127,48127
268592.0,2166.0,994.0,3199.0,1274,108124,74789,17990,13140,12855,285,56799,48716,47081,1635,74789,46475,0.4794,38.7,83041,271326,156975,16554,22668,4404,25419,45306,"Webb County, Texas",48,479,48479
1953.0,84.0,14.0,0.0,0,880,694,265,178,178,0,429,388,377,11,694,72500,0.3981,39.7,921,1909,1737,32,0,0,11,129,"Armstrong County, Texas",48,011,48011
7612.0,349.0,89.0,56.0,38,3302,2532,756,479,464,15,1776,1347,1274,73,2532,50142,0.4083,44.2,3194,7590,5126,287,392,12,578,1195,"Castro County, Texas",48,069,48069
30751.0,2173.0,910.0,235.0,0,13210,10955,2789,1591,1540,51,8166,6299,5439,860,10955,43730,0.4861,38.0,13283,30046,23910,838,652,78,423,4145,"Kleberg County, Texas",48,273,48273
39774.0,2584.0,590.0,83.0,20,18985,15351,4929,3287,3203,84,10422,8299,7617,682,15351,60202,0.436,41.0,16928,39576,31826,735,1327,233,1258,4197,"Cooke County, Texas",48,097,48097
5710.0,440.0,18.0,27.0,16,2458,2061,737,457,443,14,1324,1043,1016,27,2061,40759,0.4343,38.0,2914,5758,4353,109,53,16,70,1157,"Crosby County, Texas",48,107,48107
3787.0,136.0,1.0,2.0,0,1670,1601,639,282,274,8,962,770,718,52,1601,46146,0.4848,40.4,2210,3838,3282,28,46,21,78,383,"Fisher County, Texas",48,151,48151
11225.0,807.0,0.0,1.0,3,4258,3511,1381,837,799,38,2130,1798,1652,146,3511,41186,0.435,39.9,5581,10754,7965,273,150,34,134,2198,"Duval County, Texas",48,131,48131
11373.0,389.0,371.0,51.0,0,5199,4343,1800,1197,1179,18,2543,2117,1960,157,4343,66390,0.4697,40.8,5808,11384,9056,232,205,43,166,1682,"Blanco County, Texas",48,031,48031
35155.0,1924.0,310.0,22.0,7,13241,12936,4896,2967,2884,83,8040,6216,5935,281,12936,44370,0.4717,40.4,17280,34598,28079,266,184,114,375,5580,"Jasper County, Texas",48,241,48241
250998.0,10828.0,4073.0,865.0,617,104529,92988,25381,15344,14658,686,67607,49225,45181,4044,92988,51248,0.4776,38.6,108535,240481,178874,7186,6493,3182,12630,32116,"Jefferson County, Texas",48,245,48245
3659.0,102.0,117.0,96.0,9,1220,1337,711,285,285,0,626,464,377,87,1337,26738,0.4762,40.6,1995,3386,2623,192,207,30,10,324,"Kinney County, Texas",48,271,48271
2076.0,148.0,55.0,1.0,0,933,594,193,121,114,7,401,342,317,25,594,64545,0.439,43.4,757,1669,1438,28,30,8,2,163,"Oldham County, Texas",48,359,48359
12982.0,691.0,149.0,23.0,10,5515,4728,1418,804,788,16,3310,2570,2477,93,4728,45111,0.4453,41.8,6074,12922,9359,329,266,95,547,2326,"Lamb County, Texas",48,279,48279
3333.0,95.0,67.0,3.0,0,1582,1192,361,252,236,16,831,690,653,37,1192,59091,0.4363,43.4,1480,3357,2421,68,199,1,167,501,"Lipscomb County, Texas",48,295,48295
7874.0,372.0,62.0,0.0,3,3572,3143,1221,826,803,23,1922,1374,1265,109,3143,47707,0.4423,43.9,4333,7915,5925,121,235,7,115,1512,"McCulloch County, Texas",48,307,48307
4186.0,130.0,140.0,1.0,0,1946,1696,798,495,445,50,898,650,630,20,1696,42276,0.5095,39.8,2769,4176,3246,31,106,22,214,557,"Mason County, Texas",48,319,48319
2178.0,156.0,39.0,1.0,4,765,845,339,187,171,16,506,354,331,23,845,42540,0.5147,41.3,1357,2088,1670,21,9,9,6,373,"Dickens County, Texas",48,125,48125
7022.0,351.0,91.0,0.0,0,3619,3022,908,513,496,17,2114,1652,1505,147,3022,64511,0.4137,40.8,3283,7023,6617,64,16,0,0,326,"Pierce County, Nebraska",31,139,31139
1177.0,25.0,23.0,0.0,0,622,544,205,120,120,0,339,280,251,29,544,48269,0.3977,43.0,803,1219,1094,19,9,0,0,97,"Sioux County, Nebraska",31,165,31165
6472.0,291.0,107.0,10.0,3,2915,2856,1068,608,559,49,1788,1405,1333,72,2856,54203,0.4596,40.8,3464,6415,5690,19,60,2,12,632,"Burt County, Nebraska",31,021,31021
25663.0,1367.0,458.0,80.0,3,13102,9945,3031,1999,1881,118,6914,5511,5104,407,9945,71846,0.3954,39.6,11527,25475,23663,180,50,29,60,1493,"Cass County, Nebraska",31,025,31025
8842.0,189.0,72.0,0.0,0,4513,3727,1247,653,644,9,2480,1875,1770,105,3727,56768,0.405,41.9,4240,8793,7842,130,158,22,171,470,"Cuming County, Nebraska",31,039,31039
5635.0,332.0,36.0,2.0,0,2884,2352,808,490,468,22,1544,1144,1101,43,2352,56905,0.4117,41.8,2716,5631,4946,115,236,7,34,293,"Dixon County, Nebraska",31,051,31051
1888.0,61.0,203.0,4.0,1,900,872,322,132,129,3,550,378,348,30,872,41716,0.4011,43.4,1100,1877,1563,10,19,0,97,188,"Dundy County, Nebraska",31,057,31057
714.0,31.0,10.0,0.0,0,348,288,103,71,69,2,185,134,129,5,288,46500,0.4428,45.1,394,718,633,3,0,0,0,82,"Grant County, Nebraska",31,075,31075
2338.0,66.0,56.0,5.0,0,1163,1019,424,235,234,1,595,455,437,18,1019,47869,0.4146,40.9,1302,2356,2191,15,7,0,8,135,"Greeley County, Nebraska",31,077,31077
60439.0,2259.0,1136.0,312.0,113,31098,23096,6236,3728,3511,217,16860,13390,12201,1189,23096,57104,0.4378,39.5,24832,60411,47661,2396,3141,524,2342,4347,"Hall County, Nebraska",31,079,31079
879.0,23.0,7.0,2.0,0,471,403,121,63,62,1,282,209,199,10,403,51726,0.4726,45.8,529,893,772,22,25,0,7,67,"Hayes County, Nebraska",31,085,31085
15675.0,798.0,256.0,7.0,0,8075,6510,2078,1082,1024,58,4432,3532,3217,315,6510,59167,0.4338,40.8,7169,15717,14346,99,272,12,234,754,"Otoe County, Nebraska",31,131,31131
10701.0,403.0,297.0,19.0,7,5602,4519,1575,849,822,27,2944,2245,1996,249,4519,48808,0.4352,40.3,5325,10505,9533,76,36,0,32,828,"Red Willow County, Nebraska",31,145,31145
8393.0,291.0,181.0,33.0,0,4460,3506,1247,727,704,23,2259,1806,1670,136,3506,61869,0.3965,42.6,4169,8351,7879,9,7,0,27,429,"Cedar County, Nebraska",31,027,31027
8743.0,526.0,680.0,0.0,0,4558,3525,1087,693,665,28,2438,1693,1346,347,3525,50750,0.3671,37.0,4247,8737,7795,19,74,5,4,840,"Dawes County, Nebraska",31,045,31045
5125.0,300.0,64.0,10.0,3,2096,1809,615,350,346,4,1194,931,877,54,1809,54712,0.4168,41.2,2175,4107,3738,68,51,3,40,207,"Johnson County, Nebraska",31,097,31097
9502.0,212.0,461.0,12.0,0,4981,4395,1288,583,564,19,3107,2038,1882,156,4395,53871,0.4205,42.0,5014,9508,8823,39,71,0,34,541,"Cheyenne County, Nebraska",31,033,31033
23279.0,919.0,510.0,217.0,24,11863,8965,2635,1593,1558,35,6330,5231,4734,497,8965,53721,0.411,39.8,10268,23462,16860,1789,2338,273,357,1845,"Dawson County, Nebraska",31,047,31047
1992.0,124.0,6.0,0.0,0,1015,884,371,219,205,14,513,418,397,21,884,53000,0.4061,41.4,1230,1946,1858,15,0,5,0,68,"Garfield County, Nebraska",31,071,31071
391.0,17.0,2.0,0.0,0,204,191,91,37,37,0,100,79,79,0,191,48125,0.4259,41.7,241,395,375,2,0,0,1,17,"McPherson County, Nebraska",31,117,31117
3493.0,137.0,28.0,0.0,0,1718,1546,474,249,236,13,1072,812,745,67,1546,49032,0.4498,41.4,1856,3450,3234,2,14,0,8,192,"Nance County, Nebraska",31,125,31125
5912.0,267.0,76.0,0.0,0,3172,2418,702,499,426,73,1716,1377,1316,61,2418,63986,0.3545,40.0,2694,5891,5462,118,49,18,42,202,"Stanton County, Nebraska",31,167,31167
4148.0,172.0,39.0,7.0,0,2103,1865,744,437,433,4,1121,850,785,65,1865,55324,0.4328,41.3,2303,4153,3742,40,15,0,0,356,"Valley County, Nebraska",31,175,31175
24022.0,861.0,1517.0,65.0,81,10343,9940,3179,2178,1975,203,6761,5203,4596,607,9940,57824,0.4109,39.7,10947,23230,19381,677,573,41,462,2096,"Churchill County, Nevada",32,001,32001
47932.0,1634.0,2176.0,118.0,56,20908,20741,8957,6380,5865,515,11784,9237,8343,894,20741,66810,0.4405,38.4,24399,47874,41549,1840,766,197,716,2806,"Douglas County, Nevada",32,005,32005
6595.0,594.0,385.0,0.0,21,2060,1948,702,440,399,41,1246,985,907,78,1948,50491,0.4123,37.6,2494,4720,3910,156,97,52,19,486,"Pershing County, Nevada",32,027,32027
1851.0,58.0,52.0,0.0,91,930,774,284,159,152,7,490,436,406,30,774,67105,0.4095,41.7,1226,1854,1635,21,14,0,0,184,"Eureka County, Nevada",32,011,32011
16471.0,734.0,733.0,51.0,998,8377,6500,1626,941,933,8,4874,3750,3372,378,6500,67756,0.43,41.9,7552,16623,13166,720,726,56,433,1522,"Humboldt County, Nevada",32,013,32013
9627.0,1003.0,251.0,5.0,72,3507,3516,1138,575,520,55,2378,1775,1615,160,3516,60827,0.3963,41.6,4524,8206,7449,52,73,0,104,528,"White Pine County, Nevada",32,033,32033
51535.0,1251.0,2450.0,118.0,3448,25783,18065,3876,2448,2381,67,14189,11088,10280,808,18065,81232,0.3806,41.1,21579,51636,42750,1964,1720,88,690,4424,"Elko County, Nevada",32,007,32007
43954.0,1711.0,2020.0,89.0,102,14521,19088,8854,5865,5148,717,10234,6776,6008,768,19088,47300,0.4154,38.6,22404,43935,37686,1249,689,127,1100,3084,"Nye County, Nevada",32,023,32023
3965.0,288.0,205.0,0.0,32,1655,1627,729,508,434,74,898,645,603,42,1627,66292,0.4217,37.9,1973,3943,3414,73,56,20,0,380,"Storey County, Nevada",32,029,32029
2157855.0,4757.0,97107.0,13328.0,34323,1018288,783524,219023,145132,133765,11367,564501,414954,364829,50125,783524,59340,0.4671,38.6,899870,2157777,1537808,221760,144735,19539,96717,137218,"Clark County, Nevada",32,003,32003
53830.0,2449.0,2451.0,88.0,209,22302,21189,8134,5431,4935,496,13055,10119,8941,1178,21189,56875,0.4011,39.2,23420,54146,46891,1440,1413,151,757,3494,"Lyon County, Nevada",32,019,32019
75553.0,1786.0,3123.0,214.0,103,39297,30141,10205,6110,5651,459,19936,14789,12708,2081,30141,64751,0.4324,38.0,35588,75316,68236,1670,693,23,85,4609,"Cheshire County, New Hampshire",33,005,33005
89147.0,1941.0,6123.0,991.0,563,45597,34727,11822,7346,6955,391,22905,16103,14084,2019,34727,63389,0.4847,37.4,52913,88843,78036,1985,2544,82,654,5542,"Grafton County, New Hampshire",33,009,33009
303694.0,4152.0,11406.0,998.0,1581,172152,121045,36963,24292,22971,1321,84082,68649,61201,7448,121045,93756,0.4237,39.1,132169,304029,276832,8943,4782,486,776,12210,"Rockingham County, New Hampshire",33,015,33015
42862.0,803.0,761.0,37.0,54,20440,17328,6022,4027,3760,267,11306,8418,7597,821,17328,61312,0.4379,39.0,22652,42620,38426,946,272,8,23,2945,"Sullivan County, New Hampshire",33,019,33019
408805.0,8203.0,16268.0,3275.0,2263,222739,161086,43797,28406,26816,1590,117289,91460,79353,12107,161086,81460,0.428,38.8,171192,408815,349934,20362,13284,1618,4361,19256,"Hillsborough County, New Hampshire",33,011,33011
31549.0,1001.0,1321.0,16.0,26,13972,13768,5258,3091,2880,211,8510,6059,5371,688,13768,47117,0.4293,38.2,21594,29614,26583,614,272,40,59,2046,"Coos County, New Hampshire",33,007,33007
47899.0,1101.0,1370.0,66.0,21,23334,21456,8557,5699,5307,392,12899,9617,8439,1178,21456,63153,0.4446,38.7,41168,47678,42324,681,376,116,62,4119,"Carroll County, New Hampshire",33,003,33003
364262.0,14602.0,8460.0,3610.0,13357,176016,129936,38463,23603,22641,962,91473,70480,64827,5653,129936,81057,0.5025,37.8,144855,362670,267449,37622,29674,2507,13990,11428,"Mercer County, New Jersey",34,021,34021
150459.0,5044.0,1464.0,930.0,960,60362,50729,15444,9501,8847,654,35285,27746,25666,2080,50729,54149,0.4677,36.3,56448,140369,119602,4560,3075,630,5938,6564,"Cumberland County, New Jersey",34,011,34011
326629.0,12200.0,4363.0,2802.0,8955,170538,118193,33991,22368,21570,798,84202,67735,63745,3990,118193,113611,0.4565,39.1,126717,326872,236224,48794,24648,2112,7091,8003,"Somerset County, New Jersey",34,035,34035
588287.0,15399.0,7905.0,1491.0,4431,253961,226160,94158,54776,51775,3001,132002,105545,98015,7530,226160,70909,0.4487,37.7,283297,591261,522427,26219,9330,2170,8286,22829,"Ocean County, New Jersey",34,029,34029
262997.0,6467.0,4143.0,1631.0,6858,124793,99850,33391,20270,18887,1383,66459,51341,47112,4229,99850,62110,0.4716,37.3,128251,263554,208162,22751,11234,2253,7414,11740,"Atlantic County, New Jersey",34,001,34001
817438.0,20661.0,12467.0,9322.0,39345,399174,285005,84646,56558,54964,1594,200359,165120,154279,10841,285005,89533,0.432,38.7,301566,817768,525361,143368,93157,9834,24129,21919,"Middlesex County, New Jersey",34,023,34023
62457.0,1872.0,1069.0,15.0,273,28803,23933,8100,4798,4551,247,15833,12127,11226,901,23933,66842,0.4536,38.8,27595,61812,56973,1078,477,94,642,2548,"Salem County, New Jersey",34,033,34033
92515.0,2444.0,3195.0,104.0,699,41894,40171,16750,10584,10106,478,23421,18044,16262,1782,40171,67074,0.4727,38.1,99312,90937,82337,1891,1233,273,911,4292,"Cape May County, New Jersey",34,009,34009
500630.0,11974.0,8310.0,3215.0,17732,244740,187383,55857,34179,32796,1383,131526,100650,92444,8206,187383,70451,0.4712,38.3,206078,501273,424935,29248,14288,2948,8949,20905,"Camden County, New Jersey",34,007,34007
547231.0,14063.0,7967.0,4791.0,33378,275306,190101,55172,35414,34072,1342,134929,108899,102905,5994,190101,80198,0.4945,38.9,202267,549538,364466,81142,41708,7156,35856,19210,"Union County, New Jersey",34,039,34039
660766.0,9407.0,19645.0,11239.0,149439,350621,258591,59083,36315,34437,1878,199508,149747,126002,23745,258591,71189,0.5038,39.7,282039,665210,353462,123727,102443,13275,48054,24249,"Hudson County, New Jersey",34,017,34017
123833.0,4486.0,1692.0,462.0,2053,65350,47175,15490,10382,9696,686,31685,26320,24844,1476,47175,115379,0.4346,39.1,50249,121168,107285,6910,3815,152,1043,1963,"Hunterdon County, New Jersey",34,019,34019
488497.0,12631.0,7048.0,2762.0,13966,256239,181884,56441,37008,35647,1361,125443,101643,94491,7152,181884,115527,0.459,39.2,193339,489401,384142,54505,27622,3734,9147,10251,"Morris County, New Jersey",34,027,34027
4235.0,129.0,158.0,6.0,0,1545,1679,669,415,360,55,1010,733,711,22,1679,42526,0.4711,38.8,2454,4183,3686,160,163,0,15,159,"Hidalgo County, New Mexico",35,023,35023
71491.0,803.0,1507.0,86.0,261,23319,20942,6489,4552,4356,196,14453,11102,10503,599,20942,33834,0.512,37.4,26312,72087,56360,656,709,7,232,14123,"McKinley County, New Mexico",35,031,35031
141091.0,4767.0,3537.0,340.0,543,61870,51001,16749,11704,11027,677,34252,27474,24975,2499,51001,63802,0.4209,38.2,56585,141793,123264,4491,1598,407,1025,11008,"Sandoval County, New Mexico",35,043,35043
27416.0,394.0,1131.0,10.0,103,10077,11851,5185,2995,2777,218,6666,4637,3956,681,11851,37843,0.504,37.6,15071,27189,25374,562,248,0,136,869,"Grant County, New Mexico",35,017,35017
49002.0,1367.0,2579.0,554.0,37,22315,18548,4448,2408,2277,131,14100,10446,9669,777,18548,45092,0.4453,39.9,21267,46890,39625,1029,1331,541,1855,2509,"Curry County, New Mexico",35,009,35009
16951.0,1152.0,148.0,5.0,31,7927,6036,2076,1403,1367,36,3960,3225,3118,107,6036,54744,0.4459,39.1,7763,16601,13352,262,371,17,725,1874,"Lee County, Texas",48,287,48287
2022051.0,61994.0,46350.0,15600.0,5692,1001794,708252,157366,104261,100375,3886,550886,430121,395450,34671,708252,67700,0.4586,40.0,767808,2033815,1501298,110531,95409,21633,100882,204062,"Tarrant County, Texas",48,439,48439
57341.0,5196.0,296.0,62.0,88,18989,16677,5440,3382,3235,147,11237,8840,8367,473,16677,43455,0.4299,40.9,20476,44396,36559,843,578,252,865,5299,"Anderson County, Texas",48,001,48001
171554.0,7455.0,1499.0,436.0,190,83835,57307,14835,10229,9931,298,42472,36790,35283,1507,57307,76871,0.4176,40.8,61722,172528,139406,3608,3529,1676,4523,19786,"Ellis County, Texas",48,139,48139
14632.0,615.0,130.0,20.0,95,6560,4917,1613,1106,1098,8,3304,2665,2463,202,4917,62806,0.4191,40.8,6729,14594,11361,254,679,70,424,1806,"Jackson County, Texas",48,239,48239
51292.0,2423.0,696.0,77.0,8,21747,21403,9610,6144,5936,208,11793,9162,8615,547,21403,55990,0.4698,39.7,24636,50996,41014,955,815,266,1544,6402,"Kerr County, Texas",48,265,48265
24654.0,1595.0,209.0,12.0,32,9646,9228,3351,2105,1958,147,5877,4498,4259,239,9228,47902,0.4624,40.1,11440,24254,20208,365,417,26,349,2889,"Milam County, Texas",48,331,48331
13337.0,396.0,51.0,4.0,0,5860,5487,2324,1475,1396,79,3163,2442,2367,75,5487,53516,0.4129,41.3,7384,13327,10695,311,436,52,260,1573,"Comanche County, Texas",48,093,48093
17070.0,1430.0,246.0,0.0,55,5955,5199,2033,1165,1108,57,3166,2330,2229,101,5199,39497,0.4705,39.8,7781,15526,12250,265,337,44,278,2352,"Falls County, Texas",48,145,48145
7027.0,686.0,272.0,190.0,2,2426,2120,785,484,478,6,1335,980,948,32,2120,28333,0.4985,38.8,3117,6598,5042,62,12,23,159,1300,"Brooks County, Texas",48,047,48047
29530.0,1187.0,100.0,21.0,5,13170,11301,3782,2632,2517,115,7519,6250,5917,333,11301,66206,0.4146,41.4,13278,29488,23584,783,1030,382,906,2803,"Austin County, Texas",48,015,48015
531.0,7.0,1.0,0.0,0,207,197,106,81,81,0,91,72,72,0,197,38021,0.3216,40.7,277,568,364,57,0,0,36,111,"Kenedy County, Texas",48,261,48261
20743.0,836.0,189.0,49.0,21,9478,7450,3039,1822,1769,53,4411,3445,3265,180,7450,52559,0.4721,41.3,10710,20909,16533,561,687,153,714,2261,"Colorado County, Texas",48,089,48089
65929.0,3817.0,1213.0,198.0,39,28123,22898,6854,4633,4481,152,16044,13129,12367,762,22898,56556,0.4544,40.9,28226,66220,53207,819,1068,449,1254,9423,"San Patricio County, Texas",48,409,48409
132482.0,10113.0,2591.0,352.0,160,69279,49389,13492,8434,8228,206,35897,27590,25540,2050,49389,68261,0.4263,40.0,54705,133137,114884,2669,2958,233,995,11398,"Randall County, Texas",48,381,48381
5935.0,472.0,53.0,31.0,0,2532,2082,934,529,508,21,1148,899,821,78,2082,45083,0.4742,40.9,3191,5326,4085,51,197,30,254,709,"San Saba County, Texas",48,411,48411
2975.0,21.0,8.0,0.0,12,1326,1075,383,217,189,28,692,511,480,31,1075,53229,0.414,43.0,1508,2980,2023,165,148,47,53,544,"Schleicher County, Texas",48,413,48413
11856.0,255.0,297.0,26.0,14,4279,3571,1246,892,848,44,2325,2107,2033,74,3571,34459,0.4146,39.1,4385,11875,9256,281,433,7,84,1814,"Zavala County, Texas",48,507,48507
21409.0,820.0,341.0,162.0,44,9405,7582,2434,1585,1545,40,5148,3924,3590,334,7582,58776,0.4164,40.9,12012,21444,15452,947,951,149,736,3209,"Calhoun County, Texas",48,057,48057
1272.0,102.0,23.0,0.0,0,558,533,228,130,130,0,305,237,216,21,533,43625,0.4655,42.1,873,1239,1017,20,20,2,8,172,"Foard County, Texas",48,155,48155
7519.0,371.0,78.0,0.0,0,3075,2727,1044,628,606,22,1683,1382,1316,66,2727,60690,0.4791,39.9,3771,7464,6487,92,159,13,65,648,"Goliad County, Texas",48,175,48175
8291.0,320.0,14.0,50.0,0,3315,2989,1217,783,773,10,1772,1361,1321,40,2989,50825,0.4646,40.3,4542,8116,6597,110,80,39,148,1142,"Hamilton County, Texas",48,193,48193
8475.0,836.0,217.0,28.0,0,2789,2382,847,558,525,33,1535,1129,989,140,2382,51492,0.4497,41.8,4079,6484,5093,101,115,3,1,1171,"Mitchell County, Texas",48,335,48335
32263.0,751.0,319.0,98.0,35,14325,10893,3220,2331,2269,62,7673,6445,6168,277,10893,50196,0.4182,39.8,12408,32418,22341,1332,2879,392,1853,3621,"Titus County, Texas",48,449,48449
19785.0,1298.0,170.0,46.0,0,9021,7826,3108,1915,1889,26,4718,3886,3720,166,7826,54403,0.4715,41.7,10479,19582,17020,184,396,17,411,1554,"Lavaca County, Texas",48,285,48285
12351.0,1001.0,145.0,65.0,13,4814,4061,1319,826,820,6,2742,2192,2055,137,4061,44627,0.4333,43.4,4857,11535,8259,304,305,79,629,1959,"Terry County, Texas",48,445,48445
65521.0,4434.0,611.0,93.0,52,29524,22369,6559,4495,4309,186,15810,13106,12544,562,22369,64536,0.4215,40.6,24796,65372,50958,1270,1434,223,2162,9325,"Wise County, Texas",48,497,48497
36424.0,1071.0,253.0,204.0,129,15449,13848,4153,2601,2526,75,9695,6932,6736,196,13848,48913,0.4668,40.2,19554,36305,27830,932,1031,531,1403,4578,"Matagorda County, Texas",48,321,48321
15676.0,1082.0,50.0,18.0,10,6007,4656,1317,883,883,0,3339,2586,2456,130,4656,52397,0.4491,42.2,5754,13542,9938,559,595,125,479,1846,"Pecos County, Texas",48,371,48371
95923.0,6739.0,1790.0,611.0,383,47766,33032,8221,5785,5605,180,24811,21802,20990,812,33032,100920,0.3996,40.8,34268,96467,79435,3447,2479,739,2083,8284,"Rockwall County, Texas",48,397,48397
134832.0,7522.0,3732.0,956.0,395,66811,49868,13432,8434,8044,390,36436,28285,24696,3589,49868,53143,0.4533,39.3,57456,131204,106759,2940,3183,803,1561,15958,"Taylor County, Texas",48,441,48441
1429.0,109.0,39.0,2.0,0,665,668,281,159,156,3,387,279,268,11,668,40000,0.5012,41.8,1028,1432,1201,3,0,8,0,220,"Throckmorton County, Texas",48,447,48447
71859.0,7184.0,1274.0,216.0,133,25989,21963,5759,3656,3609,47,16204,12013,9516,2497,21963,43742,0.4711,37.9,26164,58240,47003,1171,2323,108,1482,6153,"Walker County, Texas",48,471,48471
43937.0,3235.0,1142.0,82.0,40,15977,16510,7627,5126,4850,276,8883,6976,6792,184,16510,53394,0.473,40.3,21264,43361,36565,585,514,139,303,5255,"Wood County, Texas",48,499,48499
24149.0,1633.0,479.0,335.0,19,9531,9548,4350,2741,2636,105,5198,3798,3496,302,9548,45137,0.5348,36.9,16165,24093,18019,699,568,236,621,3950,"Aransas County, Texas",48,007,48007
2815.0,69.0,65.0,15.0,2,1190,998,312,179,174,5,686,521,513,8,998,40962,0.4679,46.3,1347,2863,1922,49,109,26,194,563,"Cochran County, Texas",48,079,48079
3267.0,237.0,21.0,0.0,0,1405,1644,646,348,343,5,998,694,664,30,1644,45000,0.3885,42.4,2703,3206,2652,75,4,44,10,421,"Coke County, Texas",48,081,48081
74299.0,5817.0,5205.0,1162.0,93,30503,22322,5306,3154,3056,98,17016,13823,12919,904,22322,52893,0.4227,43.0,26689,57995,48422,1961,1392,125,560,5535,"Coryell County, Texas",48,099,48099
3952.0,85.0,271.0,0.0,0,1833,1298,320,219,215,4,978,854,820,34,1298,70625,0.4392,42.8,1729,3958,2768,91,159,95,315,530,"Hemphill County, Texas",48,211,48211
21081.0,281.0,107.0,117.0,25,9823,6733,1601,1081,1016,65,5132,4197,4052,145,6733,54871,0.3756,43.6,8067,21242,13803,1134,2640,117,1684,1864,"Moore County, Texas",48,341,48341
117727.0,6647.0,1213.0,447.0,215,51353,44380,10727,6045,5787,258,33653,24566,22747,1819,44380,42528,0.4772,40.0,49951,112967,77619,4450,5946,1035,7124,16793,"Potter County, Texas",48,375,48375
8238.0,474.0,133.0,92.0,0,2748,3451,1515,1015,988,27,1936,1503,1498,5,3451,40353,0.5069,40.1,5455,8050,6773,44,41,19,98,1075,"San Augustine County, Texas",48,405,48405
3234.0,182.0,9.0,0.0,0,1490,1317,435,291,291,0,882,657,579,78,1317,46935,0.4317,38.7,1781,3270,2773,41,36,15,8,397,"Shackelford County, Texas",48,417,48417
62821.0,814.0,165.0,411.0,58,21143,16188,4887,3294,3246,48,11301,9817,9723,94,16188,30387,0.5096,37.6,19796,63545,31993,3848,5617,1457,7138,13492,"Starr County, Texas",48,427,48427
3606.0,135.0,26.0,33.0,6,1427,1332,457,282,259,23,875,645,604,41,1332,52171,0.4365,43.6,1686,3602,2934,111,152,5,156,244,"Upton County, Texas",48,461,48461
37613.0,1989.0,158.0,36.0,41,16155,14409,4986,2910,2741,169,9423,7411,6831,580,14409,48365,0.4767,40.0,18979,36785,30202,668,596,165,222,4932,"Brown County, Texas",48,049,48049
3032.0,139.0,31.0,8.0,1,1220,1267,471,251,242,9,796,595,561,34,1267,34673,0.4961,41.6,1916,2993,2152,29,83,30,203,496,"Hall County, Texas",48,191,48191
10596.0,512.0,141.0,28.0,29,4538,3965,1573,945,900,45,2392,2002,1917,85,3965,53783,0.4516,42.1,5827,10622,8720,137,270,0,183,1312,"Franklin County, Texas",48,159,48159
19748.0,1564.0,108.0,1767.0,0,6523,4542,1677,1190,1170,20,2865,2247,2202,45,4542,46729,0.5087,41.1,5993,15664,11629,493,167,54,421,2900,"Frio County, Texas",48,163,48163
20665.0,683.0,330.0,31.0,0,8959,7807,2624,1750,1680,70,5183,4230,4090,140,7807,60772,0.4147,39.4,9401,20512,17001,344,488,19,102,2558,"Lampasas County, Texas",48,281,48281
26708.0,509.0,384.0,50.0,33,12395,11779,4148,2454,2278,176,7631,5817,5239,578,11779,49168,0.4341,39.2,17545,26204,24293,567,415,39,13,877,"Orleans County, Vermont",50,019,50019
6963.0,253.0,107.0,16.0,17,3565,2956,994,669,620,49,1962,1549,1395,154,2956,71587,0.444,39.6,5290,7016,6465,227,73,8,3,240,"Grand Isle County, Vermont",50,013,50013
160896.0,4221.0,8500.0,1564.0,2539,90442,66160,17150,9860,9043,817,49010,37160,28424,8736,66160,73647,0.4483,37.2,69734,161285,142423,7210,6723,172,456,4301,"Chittenden County, Vermont",50,007,50007
25103.0,733.0,832.0,57.0,77,13529,10546,3107,2027,1731,296,7439,5627,4866,761,10546,64003,0.488,38.2,13681,25244,23332,320,341,0,73,1178,"Lamoille County, Vermont",50,015,50015
48521.0,1119.0,625.0,41.0,99,24959,18563,5411,3060,2861,199,13152,10530,9615,915,18563,65485,0.401,39.5,22562,48679,45522,890,399,27,47,1794,"Franklin County, Vermont",50,011,50011
30038.0,1010.0,860.0,26.0,17,14455,12434,4289,2569,2408,161,8145,6136,5250,886,12434,50563,0.4595,38.3,16380,29807,27803,385,262,38,23,1296,"Caledonia County, Vermont",50,005,50005
42516.0,565.0,1701.0,121.0,244,21315,18943,6810,3704,3368,336,12133,8576,7353,1223,18943,51985,0.4672,36.8,30586,42382,38943,758,478,28,165,2010,"Windham County, Vermont",50,025,50025
35529.0,621.0,1131.0,83.0,95,16937,14581,5628,3267,2925,342,8953,6711,6084,627,14581,56183,0.4714,36.6,21153,35298,32730,652,382,20,38,1476,"Bennington County, Vermont",50,003,50003
36671.0,1089.0,1581.0,227.0,102,19665,14584,4968,3077,2844,233,9616,7328,6406,922,14584,68825,0.4068,37.6,17431,36634,33473,780,789,26,178,1388,"Addison County, Vermont",50,001,50001
6160.0,183.0,182.0,4.0,9,2707,2740,1156,661,613,48,1584,1183,1101,82,2740,44349,0.4179,38.2,5167,6200,5732,150,78,0,0,240,"Essex County, Vermont",50,009,50009
56734.0,997.0,1715.0,97.0,203,26308,21251,5964,3743,3616,127,15287,12211,11482,729,21251,65328,0.4322,41.8,24576,57132,48973,1217,1519,20,1014,4389,"Eddy County, New Mexico",35,015,35015
4536.0,66.0,5.0,0.0,0,1445,1713,867,628,500,128,846,455,338,117,1713,28446,0.4764,33.7,2981,4536,4262,31,15,0,0,228,"Mora County, New Mexico",35,033,35033
124866.0,1090.0,3561.0,223.0,163,49071,43387,13061,8862,8411,451,30326,23758,22238,1520,43387,50518,0.4462,39.3,51113,125242,106034,995,1343,117,1117,15636,"San Juan County, New Mexico",35,045,35045
8180.0,294.0,109.0,0.0,32,2970,3149,1015,630,619,11,2134,1499,1463,36,3149,36258,0.4587,40.0,4256,8156,6873,25,11,29,60,1158,"Benton County, Mississippi",28,009,28009
7615.0,167.0,50.0,0.0,0,2644,2928,987,681,657,24,1941,1489,1439,50,2928,40219,0.4748,39.2,4269,7655,6904,15,11,0,2,723,"Franklin County, Mississippi",28,037,28037
22801.0,418.0,391.0,0.0,49,7756,8782,2454,1521,1456,65,6328,4449,4181,268,8782,29121,0.5442,37.2,10711,22938,19871,41,33,10,21,2962,"Coahoma County, Mississippi",28,027,28027
16356.0,543.0,67.0,10.0,0,6289,6629,2286,1628,1604,24,4343,3156,3142,14,6629,35872,0.4861,40.5,8409,16451,14254,43,0,0,0,2154,"Jasper County, Mississippi",28,061,28061
67278.0,1770.0,372.0,8.0,37,28029,24858,7982,4867,4706,161,16876,13103,12281,822,24858,41775,0.4806,40.0,29095,67560,59135,166,553,37,956,6713,"Jones County, Mississippi",28,067,28067
14118.0,415.0,312.0,0.0,0,5139,5601,1986,989,962,27,3615,2488,2409,79,5601,30961,0.5542,41.7,7282,14343,11976,9,22,9,9,2318,"Walthall County, Mississippi",28,147,28147
35246.0,858.0,127.0,17.0,24,14007,13966,4731,2623,2588,35,9235,6880,6534,346,13966,42354,0.4638,39.8,16561,35195,31530,35,53,140,64,3373,"Monroe County, Mississippi",28,095,28095
31238.0,1046.0,466.0,23.0,10,13050,10783,3133,2071,1999,72,7650,6241,5944,297,10783,44759,0.4259,40.5,12895,31368,26059,79,274,72,652,4232,"Pontotoc County, Mississippi",28,115,28115
17562.0,433.0,130.0,19.0,43,4961,6188,1844,1074,1056,18,4344,2798,2666,132,6188,21504,0.5747,38.1,8554,17560,14705,16,4,0,0,2835,"Holmes County, Mississippi",28,051,28051
12373.0,302.0,69.0,21.0,123,4171,5218,2087,1119,1116,3,3131,2410,2285,125,5218,33981,0.513,42.0,6789,12304,10614,16,20,0,17,1637,"Amite County, Mississippi",28,005,28005
103530.0,5207.0,1862.0,287.0,155,52038,39635,9315,6133,5978,155,30320,23375,22219,1156,39635,71824,0.4737,40.2,43218,103563,92989,2227,1238,125,1028,5956,"Madison County, Mississippi",28,089,28089
14380.0,372.0,60.0,0.0,0,5364,5846,1895,1099,1059,40,3951,2836,2693,143,5846,37263,0.4152,40.9,7007,14307,12418,77,119,25,244,1424,"Calhoun County, Mississippi",28,013,28013
24682.0,818.0,367.0,21.0,52,8295,9483,3289,1776,1741,35,6194,4310,4122,188,9483,32090,0.4924,41.1,12060,24250,20416,36,86,12,105,3595,"Marion County, Mississippi",28,091,28091
19270.0,354.0,160.0,64.0,0,7570,7635,2826,1647,1645,2,4809,3738,3390,348,7635,37681,0.443,40.2,10428,19202,16490,13,59,0,8,2632,"Tishomingo County, Mississippi",28,141,28141
20033.0,644.0,175.0,19.0,77,7659,7683,2582,1449,1371,78,5101,4173,4019,154,7683,37706,0.5072,43.1,9440,20251,18280,53,48,0,59,1811,"Wayne County, Mississippi",28,153,28153
13610.0,1390.0,183.0,50.0,0,3174,3925,1282,673,661,12,2643,2196,1963,233,3925,49677,0.4195,43.6,5166,9795,8025,12,200,0,0,1558,"Greene County, Mississippi",28,041,28041
35133.0,1327.0,539.0,7.0,47,13890,12772,4356,3035,2906,129,8416,6278,5926,352,12772,42233,0.4511,39.8,15547,34141,29482,113,78,65,298,4105,"Marshall County, Mississippi",28,093,28093
7080.0,88.0,11.0,2.0,0,2247,3027,953,570,533,37,2074,1397,1300,97,3027,25283,0.4643,38.0,3581,7017,5778,18,0,0,0,1221,"Quitman County, Mississippi",28,119,28119
54790.0,1072.0,2598.0,72.0,1,21134,21020,7188,4841,4701,140,13832,10871,10377,494,21020,46901,0.4381,40.0,25386,54450,46164,353,196,26,259,7452,"Pearl River County, Mississippi",28,109,28109
22578.0,858.0,275.0,51.0,30,8295,8105,2643,1520,1478,42,5462,4275,4113,162,8105,37096,0.4923,41.9,9567,22145,18660,62,79,0,304,3040,"Leake County, Mississippi",28,079,28079
28872.0,872.0,373.0,39.0,45,11074,10657,3117,1902,1831,71,7540,5619,5353,266,10657,37987,0.467,40.1,12535,28854,25149,70,148,16,185,3286,"Neshoba County, Mississippi",28,099,28099
151349.0,8017.0,3342.0,345.0,6,73906,55909,15629,9744,9500,244,40280,32201,30270,1931,55909,65996,0.4082,40.1,60483,147374,130639,1675,1312,286,1098,12364,"Rankin County, Mississippi",28,121,28121
45329.0,754.0,664.0,85.0,15,16122,17988,5546,3295,3148,147,12442,8714,8084,630,17988,29705,0.5365,38.4,21591,45604,38181,119,162,73,143,6926,"Washington County, Mississippi",28,151,28151
12503.0,491.0,119.0,10.0,40,4586,4849,1592,964,957,7,3257,2541,2428,113,4849,41914,0.4585,40.3,6173,12633,11079,27,0,3,55,1469,"Lawrence County, Mississippi",28,077,28077
11926.0,651.0,184.0,11.0,0,4509,4623,1471,1019,1012,7,3152,2434,2335,99,4623,42469,0.4848,42.9,5658,11891,10149,69,22,17,0,1634,"Perry County, Mississippi",28,111,28111
17030.0,540.0,224.0,23.0,0,6721,6476,2080,1160,1141,19,4396,3234,3137,97,6476,36548,0.4516,39.2,7596,16744,14542,67,87,0,174,1874,"Chickasaw County, Mississippi",28,017,28017
10007.0,220.0,70.0,0.0,0,3407,3827,1441,1004,966,38,2386,1817,1719,98,3827,46052,0.4482,40.8,5181,9843,9082,0,0,0,0,761,"Carroll County, Mississippi",28,015,28015
23709.0,558.0,288.0,10.0,74,8227,7592,2418,1449,1402,47,5174,3993,3907,86,7592,47292,0.4574,39.9,9527,23369,19077,43,62,68,96,4023,"George County, Mississippi",28,039,28039
20879.0,641.0,199.0,0.0,21,8191,8391,2683,1462,1402,60,5708,4234,3960,274,8391,40122,0.4692,39.3,10243,20740,18283,0,22,0,21,2414,"Grenada County, Mississippi",28,043,28043
7147.0,174.0,60.0,0.0,0,1908,2448,905,627,627,0,1543,866,861,5,2448,25019,0.4939,38.0,3770,6722,5489,110,52,0,0,1071,"Jefferson County, Mississippi",28,063,28063
21103.0,832.0,124.0,20.0,24,7904,8037,2579,1548,1518,30,5458,4289,4179,110,8037,35958,0.4667,39.7,9508,21220,18650,135,42,0,82,2311,"Newton County, Mississippi",28,101,28101
24992.0,981.0,110.0,6.0,4,9602,9145,3097,1876,1791,85,6048,4533,4301,232,9145,39256,0.4654,39.8,11206,24968,21516,142,307,36,11,2956,"Prentiss County, Mississippi",28,117,28117
4376.0,125.0,10.0,0.0,14,1549,1751,599,442,388,54,1152,689,658,31,1751,29394,0.4998,39.7,2150,4302,3529,6,0,0,38,729,"Sharkey County, Mississippi",28,125,28125
8240.0,344.0,25.0,0.0,11,2942,3228,1298,661,657,4,1930,1380,1353,27,3228,36777,0.4758,40.9,4195,8145,7449,2,0,7,0,687,"Choctaw County, Mississippi",28,019,28019
46441.0,1091.0,1355.0,93.0,64,19417,20036,6985,4282,4093,189,13051,9855,8988,867,20036,48119,0.4526,39.5,25261,46762,39901,619,190,0,108,5944,"Hancock County, Mississippi",28,045,28045
23125.0,1368.0,175.0,0.0,12,9915,8653,2797,1956,1897,59,5856,4699,4310,389,8653,44567,0.4215,39.4,10298,23193,20788,0,31,17,14,2343,"Itawamba County, Mississippi",28,057,28057
1339.0,205.0,13.0,0.0,1,309,483,176,92,72,20,307,211,202,9,483,24208,0.5659,40.4,565,1063,939,0,0,0,0,124,"Issaquena County, Mississippi",28,055,28055
140659.0,2608.0,2886.0,532.0,94,61418,52423,15719,9571,9245,326,36704,27517,25436,2081,52423,51657,0.4623,39.4,62121,140638,117644,2560,1331,212,1274,17617,"Jackson County, Mississippi",28,059,28059
28891.0,412.0,345.0,35.0,82,9232,9962,2879,1414,1373,41,7083,4871,4677,194,9962,26735,0.5857,38.9,13126,28704,24142,145,245,10,176,3986,"Leflore County, Mississippi",28,083,28083
9835.0,303.0,161.0,9.0,0,4157,3930,915,538,526,12,3015,2109,1821,288,3930,39370,0.5046,40.8,4915,9873,8113,52,218,0,0,1490,"Tunica County, Mississippi",28,143,28143
8989.0,185.0,124.0,86.0,29,2638,2908,1090,741,702,39,1818,1240,1195,45,2908,29338,0.4696,37.4,4336,9034,7612,0,16,35,35,1336,"Claiborne County, Mississippi",28,021,28021
202082.0,7508.0,12454.0,713.0,282,89473,78104,21716,13367,12836,531,56388,42578,38744,3834,78104,47894,0.4602,39.3,92687,196504,160644,3663,2410,559,2008,27220,"Harrison County, Mississippi",28,047,28047
75403.0,2125.0,2127.0,101.0,2,31851,29736,9144,5405,5202,203,20592,14882,14105,777,29736,42534,0.504,39.4,35297,72843,64397,288,307,122,710,7019,"Lauderdale County, Mississippi",28,075,28075
33742.0,924.0,308.0,15.0,90,13136,12699,3955,2403,2359,44,8744,6975,6695,280,12699,42606,0.4762,39.1,15581,33802,28872,44,48,24,65,4749,"Lincoln County, Mississippi",28,085,28085
26789.0,1498.0,267.0,36.0,0,10677,9486,3313,1943,1912,31,6173,4981,4705,276,9486,43850,0.4773,40.8,12175,26317,22350,174,77,0,19,3697,"Simpson County, Mississippi",28,127,28127
18148.0,1158.0,182.0,1.0,26,6917,7269,2725,1685,1621,64,4544,3177,3116,61,7269,34724,0.5275,39.4,8755,17766,15424,6,0,0,50,2286,"Winston County, Mississippi",28,159,28159
18081.0,768.0,130.0,31.0,84,6615,6941,2490,1507,1430,77,4451,3396,3305,91,6941,33767,0.5098,40.1,9239,18137,16131,69,18,22,61,1836,"Attala County, Mississippi",28,007,28007
61060.0,6070.0,1970.0,94.0,33,27634,22116,5475,3454,3402,52,16641,13269,12182,1087,22116,60328,0.4635,40.0,24569,61301,52036,787,414,79,447,7538,"Lamar County, Mississippi",28,073,28073
83981.0,2995.0,1444.0,80.0,15,38168,32099,9002,5460,5325,135,23097,17440,16314,1126,32099,50559,0.4674,39.8,36790,84122,73495,333,679,112,585,8918,"Lee County, Mississippi",28,081,28081
14026.0,189.0,721.0,22.0,66,4308,4369,1407,767,704,63,2962,2225,2071,154,4369,29864,0.5244,38.8,5635,11799,10307,13,26,22,0,1431,"Tallahatchie County, Mississippi",28,135,28135
15896.0,465.0,15.0,29.0,13,6096,5820,2044,1188,1183,5,3776,3030,2926,104,5820,43105,0.4958,41.0,7377,15921,13582,93,17,0,42,2187,"Smith County, Mississippi",28,129,28129
45836.0,552.0,626.0,208.0,47,19136,18235,5397,3090,3021,69,12838,9097,8459,638,18235,45113,0.4855,39.1,22062,46002,39819,461,248,103,77,5294,"Warren County, Mississippi",28,149,28149
15548.0,224.0,276.0,9.0,6,6126,6237,2149,1354,1337,17,4088,3147,3060,87,6237,43207,0.4894,44.3,8000,15709,14268,60,0,0,0,1381,"Clarke County, Mississippi",28,023,28023
9971.0,242.0,62.0,0.0,0,4001,4539,1593,897,894,3,2946,2314,2170,144,4539,39840,0.507,41.4,5704,9937,8937,0,77,7,0,916,"Montgomery County, Mississippi",28,097,28097
48915.0,3650.0,2046.0,277.0,116,20050,17798,3870,2314,2301,13,13928,9798,6962,2836,17798,40453,0.5373,34.7,21912,49138,42728,491,1316,6,216,4381,"Oktibbeha County, Mississippi",28,105,28105
57753.0,1114.0,1648.0,139.0,298,30659,24828,7795,4370,4014,356,17033,12442,10920,1522,24828,62791,0.4382,37.7,30760,57826,54386,1053,570,51,23,1743,"Washington County, Vermont",50,023,50023
12721.0,359.0,216.0,69.0,16,5345,4337,1413,929,928,1,2924,2579,2491,88,4337,62242,0.4098,37.6,5084,12714,10434,252,313,45,329,1341,"Millard County, Utah",49,027,49027
66302.0,4326.0,1136.0,199.0,403,30446,20478,4291,2831,2788,43,16187,14202,13624,578,20478,74562,0.3425,38.8,21959,66977,59847,1081,1210,158,468,4213,"Tooele County, Utah",49,045,49045
163835.0,4796.0,7353.0,555.0,361,67912,57144,22486,15342,14797,545,34658,29773,27577,2196,57144,59839,0.4459,36.5,68789,164418,137454,3081,1997,571,3201,18114,"Washington County, Utah",49,053,49053
7373.0,180.0,694.0,13.0,2,3257,2643,1058,667,649,18,1585,1082,854,228,2643,47044,0.4346,36.0,6027,7372,6137,210,14,0,0,1011,"Kane County, Utah",49,025,49025
40789.0,986.0,1947.0,303.0,468,22408,14220,3262,2407,2283,124,10958,9111,8412,699,14220,102958,0.4996,38.8,28026,40943,35470,1277,1446,50,1160,1540,"Summit County, Utah",49,043,49043
9511.0,144.0,80.0,2.0,3,4852,4191,1252,731,729,2,2939,2194,1971,223,4191,51557,0.3981,38.3,5440,9575,7549,136,252,0,288,1350,"Grand County, Utah",49,019,49019
1851.0,37.0,30.0,0.0,7,595,532,291,195,193,2,241,190,186,4,532,42813,0.4068,35.7,950,1831,1468,2,0,2,11,348,"Piute County, Utah",49,031,49031
2363.0,11.0,38.0,0.0,21,754,635,235,152,149,3,400,351,348,3,635,57902,0.4211,38.0,3034,2384,2024,4,97,0,26,233,"Rich County, Utah",49,033,49033
31348.0,1930.0,1833.0,125.0,34,15455,9879,2301,1776,1747,29,7578,6339,5805,534,9879,85166,0.4286,38.2,13221,31563,27440,878,686,277,570,1712,"Wasatch County, Utah",49,051,49051
6376.0,128.0,130.0,14.0,2,2659,2282,663,357,357,0,1619,1357,1322,35,2282,55221,0.3921,38.7,3023,6460,5346,116,178,36,159,625,"Beaver County, Utah",49,001,49001
53054.0,2185.0,1072.0,189.0,94,23716,17569,4748,3241,3166,75,12821,10924,10609,315,17569,62233,0.3753,36.9,18862,53576,48201,814,512,85,331,3633,"Box Elder County, Utah",49,003,49003
50547.0,2457.0,2415.0,227.0,18,22364,17015,4365,2942,2813,129,12650,10582,9540,1042,17015,51807,0.4397,35.6,21231,50814,43687,668,748,112,445,5154,"Iron County, Utah",49,021,49021
29515.0,3097.0,994.0,128.0,58,11648,8643,2687,1832,1804,28,5956,5088,4824,264,8643,53838,0.413,34.4,10770,27355,23796,369,365,58,417,2350,"Sanpete County, Utah",49,039,49039
20993.0,1019.0,443.0,41.0,39,8934,7364,2275,1484,1473,11,5089,4351,4093,258,7364,54799,0.4135,37.4,8816,20963,18446,131,28,40,189,2129,"Sevier County, Utah",49,041,49041
248077.0,11437.0,5194.0,1325.0,2032,121331,83632,19929,12902,12539,363,63703,52341,48501,3840,83632,67244,0.4004,38.1,91756,248664,214915,5909,5804,1275,4264,16497,"Weber County, Utah",49,057,49057
15069.0,328.0,286.0,21.0,39,5604,4311,1403,943,930,13,2908,2383,2282,101,4311,45394,0.4812,39.0,5994,15058,11666,7,81,8,28,3268,"San Juan County, Utah",49,037,49037
1116899.0,24176.0,34065.0,8531.0,21435,582982,374820,83356,54847,52858,1989,291464,234706,209138,25568,374820,74865,0.4335,38.2,397080,1126121,906183,49044,52735,6690,36791,74678,"Salt Lake County, Utah",49,035,49035
606.0,34.0,10.0,0.0,2,303,163,48,44,44,0,115,82,82,0,163,75417,0.3299,38.6,1276,517,505,0,0,0,0,12,"Daggett County, Utah",49,009,49009
2657.0,97.0,56.0,3.0,0,1165,1000,380,209,199,10,620,490,475,15,1000,44245,0.3939,42.0,1677,2653,2204,14,24,22,25,364,"Wayne County, Utah",49,055,49055
20012.0,937.0,432.0,40.0,40,8398,7829,2421,1496,1464,32,5408,4156,3870,286,7829,51158,0.4161,37.3,9828,20107,17823,124,256,49,71,1784,"Carbon County, Utah",49,007,49007
11557.0,347.0,326.0,35.0,19,4778,3365,811,684,668,16,2554,2347,2308,39,3365,91341,0.3703,37.2,3574,11664,10701,153,116,0,7,687,"Morgan County, Utah",49,029,49029
121814.0,5114.0,4148.0,1349.0,1308,60074,38393,7634,5212,5121,91,30759,26957,23736,3221,38393,59038,0.4268,35.0,41388,123426,109076,2484,3663,276,1667,6260,"Cache County, Utah",49,005,49005
11206.0,649.0,319.0,10.0,8,4978,3464,918,583,576,7,2546,2324,2242,82,3464,61463,0.3722,37.1,3758,11163,9692,41,115,2,48,1265,"Juab County, Utah",49,023,49023
74367.0,3702.0,3006.0,489.0,246,34079,28920,11662,8137,7953,184,17258,13638,12747,891,28920,87678,0.4354,38.9,33284,73345,64950,2739,1303,261,675,3417,"James City County, Virginia",51,095,51095
26965.0,757.0,196.0,2.0,1,9080,10812,4086,2365,2220,145,6726,5120,4825,295,10812,39758,0.466,37.8,13547,26905,24082,131,74,39,1,2578,"Russell County, Virginia",51,167,51167
30489.0,1112.0,542.0,0.0,99,12162,12686,4560,2674,2623,51,8126,6205,5793,412,12686,40932,0.4302,38.0,15398,30115,26928,40,185,20,181,2761,"Smyth County, Virginia",51,173,51173
46756.0,5401.0,2691.0,789.0,1790,24745,18617,3983,2242,1976,266,14634,9937,6491,3446,18617,59471,0.5377,36.6,20642,46679,38168,2034,2540,271,903,2763,"Charlottesville city, Virginia",51,540,51540
54528.0,2431.0,693.0,91.0,60,26115,23071,8002,4502,4333,169,15069,11805,10893,912,23071,49664,0.4295,38.8,25872,54704,48754,555,459,0,312,4624,"Campbell County, Virginia",51,031,51031
323455.0,15995.0,6166.0,3294.0,1727,169881,128464,35761,20698,19592,1106,92703,68092,61255,6837,128464,70307,0.4605,39.2,137141,325010,266102,18106,16196,1776,5992,16838,"Henrico County, Virginia",51,087,51087
25943.0,1219.0,1170.0,150.0,244,13224,9202,2240,1676,1589,87,6962,5841,5344,497,9202,94274,0.3712,38.9,10078,25663,23658,385,212,58,82,1268,"King George County, Virginia",51,099,51099
10691.0,500.0,178.0,23.0,12,4222,5062,2643,1650,1596,54,2419,1668,1593,75,5062,53711,0.5079,39.4,7625,10613,9314,166,77,0,19,1037,"Lancaster County, Virginia",51,103,51103
23769.0,567.0,617.0,19.0,10,7602,9149,3496,2020,1946,74,5653,4166,3903,263,9149,32888,0.4932,37.0,11798,22459,19630,73,16,0,9,2731,"Lee County, Virginia",51,105,51105
8700.0,552.0,140.0,3.0,13,3529,3920,1989,1233,1122,111,1931,1559,1329,230,3920,64237,0.4385,40.1,5751,8685,7512,132,0,64,0,977,"Mathews County, Virginia",51,115,51115
10554.0,841.0,208.0,76.0,0,4295,4603,2302,1390,1312,78,2301,1647,1498,149,4603,57438,0.4487,38.1,7320,10333,9214,97,92,76,8,846,"Middlesex County, Virginia",51,119,51119
37813.0,2622.0,2505.0,377.0,46,16680,11507,3487,2395,2303,92,8020,6601,6021,580,11507,71912,0.3902,39.5,12475,32853,29731,675,289,6,87,2065,"Prince George County, Virginia",51,149,51149
8843.0,1145.0,161.0,26.0,41,3244,3069,1176,781,745,36,1893,1452,1378,74,3069,49517,0.4466,38.8,3962,7267,6571,97,98,26,58,417,"Richmond County, Virginia",51,159,51159
21789.0,630.0,450.0,14.0,19,8152,8773,3473,2049,1997,52,5300,3794,3497,297,8773,39820,0.4596,38.0,11964,21126,18950,76,89,24,73,1914,"Scott County, Virginia",51,169,51169
131262.0,5726.0,2759.0,298.0,1763,65446,44436,12302,8927,8540,387,32134,27045,25251,1794,44436,88628,0.3919,38.8,47655,131998,114996,4491,2275,723,1499,8014,"Spotsylvania County, Virginia",51,177,51177
15519.0,284.0,143.0,22.0,45,7083,6091,2044,1460,1445,15,4047,3315,3081,234,6091,58696,0.4331,39.5,7314,15633,14169,63,60,1,69,1271,"Appomattox County, Virginia",51,011,51011
55656.0,1830.0,693.0,62.0,122,24671,22997,9064,6101,5870,231,13933,11296,10442,854,22997,56254,0.4591,38.8,29898,55845,49752,492,376,94,267,4864,"Franklin County, Virginia",51,067,51067
6940.0,462.0,143.0,0.0,0,3164,2707,1212,716,633,83,1495,1147,1060,87,2707,63982,0.4208,38.5,3489,7042,6536,42,3,0,41,420,"King and Queen County, Virginia",51,097,51097
97158.0,6340.0,3950.0,1412.0,1911,44597,35685,8077,5149,4990,159,27608,20737,14632,6105,35685,57977,0.4951,35.1,40264,97474,84491,2405,4588,133,483,5374,"Montgomery County, Virginia",51,121,51121
21534.0,1632.0,567.0,0.0,45,10872,7961,2630,1821,1730,91,5331,4577,4393,184,7961,87904,0.3731,39.5,8480,21097,19506,363,170,21,26,1011,"New Kent County, Virginia",51,127,51127
9725.0,278.0,67.0,88.0,4,4751,3975,1623,1028,976,52,2352,1805,1615,190,3975,47469,0.4203,38.8,4723,9814,8478,100,0,0,0,1236,"Cumberland County, Virginia",51,049,51049
14572.0,272.0,100.0,11.0,7,4310,5778,2148,1346,1327,19,3630,2623,2492,131,5778,29932,0.6002,38.6,7577,14280,12942,6,29,0,0,1303,"Dickenson County, Virginia",51,051,51051
34256.0,592.0,405.0,61.0,44,14338,14158,5968,3362,3256,106,8190,6288,5973,315,14158,42669,0.4415,40.2,18212,33813,29879,287,357,2,47,3241,"Halifax County, Virginia",51,083,51083
390361.0,14127.0,9706.0,3924.0,7668,212430,128637,24946,17947,17163,784,103691,88980,83242,5738,128637,142299,0.3866,39.6,133063,392980,286751,53382,30321,2952,9966,9608,"Loudoun County, Virginia",51,107,51107
455541.0,17506.0,12546.0,4588.0,11803,238738,142000,29697,21709,20987,722,112303,93952,88642,5310,142000,107132,0.3875,39.1,148874,453557,319579,52204,31414,7698,21210,21452,"Prince William County, Virginia",51,153,51153
17748.0,1059.0,127.0,29.0,38,7500,6562,2240,1416,1379,37,4322,3493,3340,153,6562,61348,0.3925,38.9,7627,16377,15210,47,18,0,0,1102,"Southampton County, Virginia",51,175,51175
2194.0,28.0,3.0,0.0,0,852,1078,577,385,374,11,501,377,339,38,1078,48587,0.4184,35.9,2006,2204,1961,6,0,0,0,237,"Highland County, Virginia",51,091,51091
30030.0,2193.0,1123.0,35.0,61,15465,10946,3508,2424,2327,97,7438,6014,5502,512,10946,65103,0.408,40.6,12268,28082,25352,491,147,30,253,1809,"Caroline County, Virginia",51,033,51033
36800.0,1095.0,408.0,94.0,71,17839,14786,4886,3373,3117,256,9900,7954,7349,605,14786,70537,0.3828,39.4,16571,36644,33662,413,118,38,60,2353,"Gloucester County, Virginia",51,073,51073
17653.0,512.0,391.0,28.0,0,7289,7755,3319,1949,1863,86,4436,3302,3159,143,7755,43073,0.4321,40.6,10224,17384,15370,145,53,11,12,1793,"Patrick County, Virginia",51,141,51141
28436.0,1956.0,231.0,50.0,0,13151,10265,3425,2586,2503,83,6840,5901,5524,377,10265,89090,0.3764,40.0,10893,26235,24230,259,165,40,30,1511,"Powhatan County, Virginia",51,145,51145
42722.0,1622.0,1218.0,467.0,50,20194,17402,6532,3980,3784,196,10870,8261,7566,695,17402,57252,0.4119,38.9,21221,42902,37803,773,814,50,341,3121,"Shenandoah County, Virginia",51,171,51171
69029.0,3674.0,1153.0,259.0,431,35212,24562,7710,5178,4840,338,16852,14047,13178,869,24562,100783,0.4107,39.6,26894,69323,61054,1874,1155,181,1204,3855,"Fauquier County, Virginia",51,061,51061
24138.0,2359.0,692.0,116.0,95,11859,10597,3776,1933,1790,143,6821,4751,4248,503,10597,52611,0.4382,38.5,11824,23830,20819,331,352,21,188,2119,"Staunton city, Virginia",51,790,51790
26390.0,1514.0,359.0,37.0,34,12476,9923,3534,2435,2305,130,6389,5255,4794,461,9923,76873,0.4488,38.8,10948,25206,22678,468,354,54,33,1619,"Fluvanna County, Virginia",51,065,51065
9677.0,221.0,35.0,0.0,11,3785,3782,1146,657,620,37,2636,2127,2067,60,3782,45730,0.4255,38.9,4857,9682,8637,31,0,0,0,1014,"Webster County, Mississippi",28,155,28155
36751.0,777.0,620.0,60.0,17,15019,14649,5010,2926,2829,97,9639,7298,6761,537,14649,42086,0.4654,40.7,17268,36431,31098,197,151,19,151,4815,"Alcorn County, Mississippi",28,003,28003
19358.0,338.0,219.0,0.0,0,7012,7618,2387,1481,1481,0,5231,3551,3360,191,7618,31833,0.5082,38.3,9289,19384,17013,32,36,0,25,2278,"Clay County, Mississippi",28,025,28025
18634.0,302.0,40.0,76.0,33,7259,6759,1920,1373,1325,48,4839,3740,3640,100,6759,38178,0.4543,40.5,8690,18702,16086,9,22,36,48,2501,"Covington County, Mississippi",28,031,28031
8315.0,153.0,45.0,24.0,29,2736,3186,1043,652,645,7,2143,1547,1433,114,3186,28962,0.5413,39.4,3819,8299,6913,9,24,31,117,1205,"Humphreys County, Mississippi",28,053,28053
272151.0,12078.0,6302.0,1853.0,2931,137405,112212,33211,19420,18352,1068,79001,57457,51253,6204,112212,60715,0.4511,39.3,124324,272284,239424,9498,8830,872,1894,11766,"Dauphin County, Pennsylvania",42,043,42043
152662.0,3102.0,2525.0,317.0,185,72840,60438,20250,12962,12505,457,40188,31904,29565,2339,60438,63379,0.4126,39.4,65503,152824,134822,2378,1848,199,1459,12118,"Franklin County, Pennsylvania",42,055,42055
44662.0,1666.0,2318.0,344.0,38,17684,14533,5431,3079,2990,89,9102,6935,6500,435,14533,59399,0.4563,36.6,17357,39694,34842,513,341,9,27,3962,"Union County, Pennsylvania",42,119,42119
51066.0,1970.0,1153.0,60.0,143,20707,18841,7697,4893,4694,199,11144,8616,7878,738,18841,56096,0.4179,37.8,32299,47847,44133,830,293,73,25,2493,"Wayne County, Pennsylvania",42,127,42127
47858.0,975.0,717.0,47.0,127,21536,19882,7551,4580,4380,200,12331,9647,8796,851,19882,50509,0.4138,38.8,24360,47890,44277,146,204,14,21,3228,"Bedford County, Pennsylvania",42,009,42009
166566.0,4038.0,4820.0,686.0,3425,78377,57098,18870,13139,12331,808,38228,30481,28081,2400,57098,63934,0.4208,37.6,81485,166996,141222,10945,3988,628,917,9296,"Monroe County, Pennsylvania",42,089,42089
45015.0,1856.0,581.0,59.0,40,18221,16779,6269,3880,3692,188,10510,8493,7863,630,16779,51678,0.414,37.8,22696,41136,38822,217,292,13,89,1703,"Huntingdon County, Pennsylvania",42,061,42061
205190.0,7395.0,3116.0,350.0,1370,97765,84948,29493,18057,17373,684,55455,41894,37992,3902,84948,63543,0.456,39.2,95934,205437,194099,2151,1259,95,510,7323,"Washington County, Pennsylvania",42,125,42125
1558267.0,27267.0,38107.0,13713.0,170411,684950,601337,159066,85587,80313,5274,442271,290074,245603,44471,601337,45927,0.5182,38.4,685956,1565323,1259510,103611,74694,9957,33659,83892,"Philadelphia County, Pennsylvania",42,101,42101
440906.0,8693.0,8473.0,1924.0,1784,220550,172421,53087,33790,31884,1906,119334,96005,87093,8912,172421,66457,0.4142,39.2,184135,440478,402631,9077,6290,622,2065,19793,"York County, Pennsylvania",42,133,42133
84199.0,7015.0,1127.0,329.0,217,36318,33246,10881,6786,6626,160,22365,16979,14496,2483,33246,49320,0.4553,37.9,38970,83664,76153,518,660,20,134,6179,"Indiana County, Pennsylvania",42,063,42063
246864.0,13267.0,7217.0,1565.0,857,125799,99804,30742,18731,17727,1004,69062,51451,46277,5174,99804,71269,0.4233,38.6,106028,242092,214905,7583,6220,426,979,11979,"Cumberland County, Pennsylvania",42,041,42041
1208497.0,22717.0,27102.0,7893.0,58491,617871,541541,165545,87394,82805,4589,375996,257488,220342,37146,541541,61043,0.4852,38.7,600399,1207932,1095770,32094,33720,1408,4421,40519,"Allegheny County, Pennsylvania",42,003,42003
349435.0,8818.0,3382.0,494.0,2171,169105,152283,54788,32714,31333,1381,97495,73934,67827,6107,152283,60471,0.4462,38.4,170442,349436,332385,3612,1489,154,312,11484,"Westmoreland County, Pennsylvania",42,129,42129
7274.0,853.0,70.0,19.0,1,967,1839,1057,620,590,30,782,558,489,69,1839,39717,0.392,35.4,8608,3622,3457,18,7,0,0,140,"Forest County, Pennsylvania",42,053,42053
122035.0,3636.0,1145.0,234.0,640,55724,52126,17756,10289,9795,494,34370,26019,23599,2420,52126,49181,0.4482,38.3,56847,121711,114562,1088,245,26,122,5668,"Blair County, Pennsylvania",42,013,42013
85931.0,2288.0,1396.0,55.0,379,38823,37055,13251,7782,7495,287,23804,18089,16832,1257,37055,50204,0.4622,38.8,41259,85690,80191,863,389,18,56,4173,"Lawrence County, Pennsylvania",42,073,42073
60277.0,785.0,1238.0,90.0,50,26361,25021,8913,5482,5196,286,16108,12724,11601,1123,25021,52358,0.4389,39.9,30660,60377,55274,507,551,16,42,3987,"Bradford County, Pennsylvania",42,015,42015
131863.0,3435.0,1703.0,314.0,656,55741,56674,20884,12133,11641,492,35790,25968,23639,2329,56674,46659,0.4348,37.8,65951,129775,123194,698,389,93,60,5341,"Cambria County, Pennsylvania",42,021,42021
514102.0,17705.0,11980.0,2257.0,7052,268559,190980,56386,36862,35298,1564,134594,109728,99905,9823,190980,100214,0.4614,39.1,200402,514666,447118,21061,19377,1074,7871,18165,"Chester County, Pennsylvania",42,029,42029
413879.0,11672.0,5738.0,1881.0,3121,201319,154712,48845,30643,29163,1480,105867,84875,77284,7591,154712,63728,0.4398,38.7,167105,413205,362654,14596,11356,906,4282,19411,"Berks County, Pennsylvania",42,011,42011
45741.0,1226.0,246.0,62.0,9,21106,19043,6643,4260,4148,112,12400,9957,9081,876,19043,50219,0.4121,38.5,21854,45674,39699,228,145,10,11,5581,"Mifflin County, Pennsylvania",42,087,42087
3609.0,72.0,112.0,6.0,0,1673,1271,507,299,268,31,764,538,514,24,1271,47298,0.4129,40.4,2122,3584,2934,42,36,2,4,566,"Mercer County, Missouri",29,129,29129
18015.0,847.0,593.0,34.0,0,6554,7063,2481,1517,1429,88,4582,3570,3320,250,7063,34776,0.477,38.7,8684,18017,14486,45,51,0,0,3435,"Wright County, Missouri",29,229,29229
239909.0,10586.0,7915.0,917.0,510,126064,91238,23176,14280,13587,693,68062,52362,47194,5168,91238,70510,0.4128,39.4,97868,240958,212838,6968,3029,910,1423,15790,"Clay County, Missouri",29,047,29047
15426.0,400.0,252.0,48.0,17,6257,6371,2347,1409,1317,92,4024,2904,2802,102,6371,42100,0.4537,38.3,7334,15373,12987,121,25,4,0,2236,"Dent County, Missouri",29,065,29065
22711.0,819.0,448.0,207.0,7,10300,8272,2652,1557,1488,69,5620,4056,3694,362,8272,44720,0.4346,38.8,10182,22525,19507,410,661,34,317,1596,"Saline County, Missouri",29,195,29195
2005.0,69.0,13.0,2.0,4,894,859,325,197,195,2,534,413,398,15,859,53580,0.4047,39.9,1276,1983,1841,24,0,0,0,118,"Worth County, Missouri",29,227,29227
9900.0,540.0,121.0,64.0,60,4375,3936,1467,781,737,44,2469,1859,1653,206,3936,45594,0.4293,39.9,4998,9826,7924,30,124,5,111,1632,"Grundy County, Missouri",29,079,29079
19934.0,679.0,345.0,31.0,30,7365,7588,3033,1828,1753,75,4555,3451,3176,275,7588,39003,0.4672,39.1,15598,19893,15644,44,45,18,12,4130,"Morgan County, Missouri",29,141,29141
6274.0,167.0,127.0,0.0,4,2521,2596,990,649,632,17,1606,1266,1172,94,2596,40324,0.4368,39.1,4037,6130,5421,15,3,4,4,683,"Reynolds County, Missouri",29,179,29179
986933.0,30295.0,23105.0,4956.0,11222,490886,405984,124827,72623,69616,3007,281157,209200,189488,19712,405984,67420,0.4919,38.6,440960,984954,860710,37121,26883,2700,6635,50905,"St. Louis County, Missouri",29,189,29189
31408.0,1436.0,1353.0,21.0,4,12043,12783,6249,4504,4235,269,6534,5204,4862,342,12783,49656,0.4624,39.0,21116,31240,27938,380,61,31,132,2698,"Stone County, Missouri",29,209,29209
35085.0,1929.0,583.0,40.0,27,14485,13645,4856,3307,3149,158,8789,7016,6630,386,13645,44403,0.4814,40.2,17630,35209,28696,685,791,66,296,4675,"Barry County, Missouri",29,009,29009
175429.0,8950.0,6882.0,1788.0,869,91920,70619,14863,8907,8555,352,55756,40333,31872,8461,70619,55328,0.465,36.5,77314,176323,153507,3824,6705,510,1249,10528,"Boone County, Missouri",29,019,29019
76088.0,4311.0,1334.0,145.0,169,37322,30154,8732,4572,4401,171,21422,15988,14468,1520,30154,60066,0.4155,39.3,33335,72637,64622,1039,991,158,285,5542,"Cole County, Missouri",29,051,29051
23822.0,949.0,490.0,77.0,32,9363,9578,3205,1902,1780,122,6373,4839,4412,427,9578,44438,0.437,39.4,12078,23814,19709,88,94,41,14,3868,"Crawford County, Missouri",29,055,29055
10073.0,726.0,200.0,0.0,10,3753,4074,1445,884,829,55,2629,2057,1881,176,4074,37435,0.4517,37.2,5321,9831,8611,97,10,0,6,1107,"Iron County, Missouri",29,093,29093
14923.0,955.0,336.0,24.0,29,6432,5915,1952,1196,1155,41,3963,3042,2688,354,5915,46992,0.4284,38.9,6839,13840,12217,28,64,0,21,1510,"Livingston County, Missouri",29,117,29117
15901.0,1200.0,171.0,55.0,21,6924,5436,1684,971,917,54,3752,3076,2916,160,5436,58010,0.4045,40.0,6191,14681,12380,83,37,3,5,2173,"Moniteau County, Missouri",29,135,29135
16362.0,325.0,571.0,0.0,32,5755,6730,2052,1175,1120,55,4678,3526,3166,360,6730,33859,0.49,39.6,8171,16499,14274,41,61,33,16,2074,"Pemiscot County, Missouri",29,155,29155
41916.0,1593.0,845.0,84.0,57,18339,16033,4799,2782,2682,100,11234,8537,7884,653,16033,46157,0.4306,39.2,18279,41748,34122,925,866,343,793,4699,"Pettis County, Missouri",29,159,29159
8113.0,403.0,117.0,56.0,41,2924,3064,1091,729,654,75,1973,1554,1440,114,3064,34265,0.4183,39.1,4182,8154,6612,10,3,0,0,1529,"Shannon County, Missouri",29,203,29203
24619.0,1368.0,261.0,121.0,37,10289,8626,2728,1625,1557,68,5898,4395,4110,285,8626,47740,0.4139,38.5,10781,22855,20418,228,15,20,62,2112,"Randolph County, Missouri",29,175,29175
29516.0,1038.0,719.0,114.0,34,11375,12342,3856,2009,1921,88,8486,6406,5762,644,12342,36380,0.5018,39.7,14428,29334,24343,165,244,13,505,4064,"Dunklin County, Missouri",29,069,29069
101805.0,3942.0,1125.0,34.0,87,49622,40943,12075,7445,7202,243,28868,22995,20852,2143,40943,57214,0.4311,39.0,45136,102307,93093,732,322,209,127,7824,"Franklin County, Missouri",29,071,29071
9975.0,438.0,71.0,8.0,0,4601,3471,1252,803,778,25,2219,1739,1605,134,3471,52700,0.4005,39.1,4591,9936,9098,44,23,5,0,766,"Howard County, Missouri",29,089,29089
687280.0,13330.0,22566.0,2011.0,6822,345353,286601,73362,42742,39966,2776,213239,146198,126927,19271,286601,55134,0.4627,39.2,323157,689210,584354,13776,13918,3425,10512,63225,"Jackson County, Missouri",29,095,29095
24875.0,1244.0,305.0,30.0,12,11166,10111,3097,2012,1964,48,7014,5410,5071,339,10111,47171,0.4483,39.7,12946,24836,22161,63,55,23,139,2395,"Miller County, Missouri",29,131,29131
4712.0,28.0,185.0,0.0,0,2036,1744,628,375,375,0,1116,758,686,72,1744,42849,0.4435,39.0,2992,4692,3925,20,11,0,0,736,"Putnam County, Missouri",29,171,29171
54593.0,2206.0,2335.0,222.0,132,24748,22272,8078,5186,4881,305,14194,11169,10355,814,22272,46031,0.4168,38.0,30833,54668,44930,771,310,224,922,7511,"Taney County, Missouri",29,213,29213
87012.0,4247.0,1248.0,249.0,250,40706,33501,9633,5466,5220,246,23868,17415,15302,2113,33501,51916,0.4453,38.9,38750,85440,74140,1107,1409,105,901,7778,"Buchanan County, Missouri",29,021,29021
8961.0,506.0,162.0,23.0,2,3775,3639,1256,766,745,21,2383,1789,1603,186,3639,49839,0.4022,40.5,4684,8856,7970,34,18,12,0,822,"Caldwell County, Missouri",29,025,29025
17573.0,2956.0,435.0,15.0,168,8033,5573,1116,543,530,13,4457,2721,1829,892,5573,36297,0.5438,32.1,6518,17612,15841,261,80,68,46,1316,"Radford city, Virginia",51,750,51750
27288.0,2303.0,1098.0,93.0,147,13832,10490,3051,1713,1626,87,7439,5184,4391,793,10490,58818,0.4416,38.2,11919,27669,21893,985,971,82,1634,2104,"Winchester city, Virginia",51,840,51840
32211.0,240.0,956.0,41.0,134,13616,13438,5305,3377,3252,125,8133,6098,5670,428,13438,46073,0.448,40.1,21273,32263,25820,443,636,156,1273,3935,"Accomack County, Virginia",51,001,51001
5035.0,190.0,102.0,0.0,0,2335,2297,693,449,410,39,1604,1049,1029,20,2297,55708,0.3833,38.2,2909,5094,4904,12,0,0,0,178,"Craig County, Virginia",51,045,51045
15476.0,426.0,204.0,0.0,35,7251,6493,2417,1367,1330,37,4076,3408,3151,257,6493,51521,0.4019,39.2,8048,15599,13939,160,64,75,174,1187,"Floyd County, Virginia",51,063,51063
16654.0,348.0,316.0,22.0,1,7399,6910,2538,1533,1431,102,4372,3446,3032,414,6910,54520,0.3862,38.8,8357,16653,15113,80,11,0,68,1381,"Giles County, Virginia",51,071,51071
15619.0,601.0,281.0,31.0,53,6294,6498,2659,1673,1607,66,3839,2746,2537,209,6498,36544,0.4515,38.7,9239,14708,12915,89,69,29,155,1451,"Grayson County, Virginia",51,077,51077
15263.0,1281.0,174.0,34.0,18,5726,5446,2031,1125,1101,24,3415,2663,2571,92,5446,45535,0.5061,38.8,6775,13776,11627,226,133,0,152,1638,"Nottoway County, Virginia",51,135,51135
7347.0,179.0,111.0,21.0,16,3495,2913,1327,927,891,36,1586,1166,1027,139,2913,74284,0.4633,38.6,3979,7373,6158,118,107,9,87,894,"Rappahannock County, Virginia",51,157,51157
6960.0,288.0,57.0,27.0,66,3313,2896,1173,766,717,49,1723,1238,1165,73,2896,57198,0.5152,38.7,3359,6992,6276,44,63,0,27,582,"Charles City County, Virginia",51,036,51036
50693.0,2455.0,1261.0,151.0,188,23980,17071,5351,3747,3608,139,11720,9881,9042,839,17071,77935,0.4055,39.6,18729,49800,42078,1632,1055,267,1369,3399,"Culpeper County, Virginia",51,047,51047
28244.0,1503.0,289.0,67.0,108,13476,10401,3445,2174,2023,151,6956,5314,5041,273,10401,60346,0.4326,38.0,11758,28164,24964,192,257,127,205,2419,"Dinwiddie County, Virginia",51,053,51053
19328.0,1157.0,335.0,41.0,110,9853,7548,2163,1548,1465,83,5385,4193,3856,337,7548,67398,0.3836,38.2,8291,19322,16499,245,258,17,368,1935,"Greene County, Virginia",51,079,51079
104658.0,4913.0,1511.0,242.0,131,54927,38987,12419,8267,8155,112,26568,22466,20973,1493,38987,89390,0.4024,38.8,41357,105093,96798,1955,1047,117,545,4631,"Hanover County, Virginia",51,085,51085
12190.0,312.0,32.0,25.0,48,4490,4293,1774,1161,1154,7,2519,1961,1877,84,4293,44303,0.4,39.6,5995,11311,9426,255,415,58,1,1156,"Lunenburg County, Virginia",51,111,51111
35588.0,2135.0,521.0,5.0,158,16724,13679,4875,3262,3219,43,8804,6850,6264,586,13679,71548,0.3809,39.9,15142,35477,30928,574,630,79,388,2878,"Orange County, Virginia",51,137,51137
5431.0,508.0,140.0,7.0,16,1895,2086,643,257,244,13,1443,1100,1089,11,2086,27063,0.4801,38.2,2385,5221,4407,53,34,0,63,664,"Emporia city, Virginia",51,595,51595
28612.0,810.0,226.0,27.0,8,13195,11983,4174,2590,2488,102,7809,6008,5465,543,11983,49364,0.4538,39.5,14375,28677,25989,107,58,0,0,2523,"Wythe County, Virginia",51,197,51197
236860.0,13739.0,7827.0,1605.0,657,116696,84849,21401,14323,13778,545,63448,52379,49465,2914,84849,78640,0.4114,39.4,90802,227567,200346,7684,3026,373,2481,13657,"Chesapeake city, Virginia",51,550,51550
52704.0,6951.0,3039.0,867.0,512,25039,16723,3423,1683,1603,80,13300,10064,7404,2660,16723,46679,0.4839,34.3,18261,52590,39917,2232,3913,355,2571,3602,"Harrisonburg city, Virginia",51,660,51660
106228.0,8401.0,3943.0,1391.0,1399,52397,41496,13641,8132,7742,390,27855,21274,18227,3047,41496,79880,0.4794,37.2,45520,106023,89523,4696,4680,199,1532,5393,"Albemarle County, Virginia",51,003,51003
77533.0,4125.0,1429.0,301.0,3,36290,31317,10996,7563,7364,199,20321,16359,15234,1125,31317,64199,0.4408,39.1,36743,78005,70547,1154,794,47,282,5181,"Bedford County, Virginia",51,019,51019
16891.0,1068.0,106.0,23.0,44,6565,5826,2195,1405,1339,66,3631,2793,2605,188,5826,49025,0.397,39.7,7444,14974,13204,83,43,0,2,1642,"Buckingham County, Virginia",51,029,51029
38148.0,1232.0,988.0,84.0,90,12465,14925,4658,2768,2685,83,10267,7886,7225,661,14925,38888,0.4731,39.4,17958,36190,31943,192,78,12,91,3874,"Wise County, Virginia",51,195,51195
5557.0,378.0,42.0,28.0,0,2518,2384,848,483,457,26,1536,1085,1003,82,2384,40655,0.4479,37.7,2997,5498,4791,147,13,0,28,519,"Covington city, Virginia",51,580,51580
93753.0,5498.0,2926.0,347.0,782,44106,36370,10245,5935,5500,435,26125,17887,15708,2179,36370,52175,0.4324,39.4,40907,89616,78825,1071,730,126,491,8373,"Portsmouth city, Virginia",51,740,51740
444210.0,15254.0,18809.0,4215.0,2036,240595,170798,44087,28381,27282,1099,126711,100644,89527,11117,170798,76610,0.4171,40.2,184794,424868,357234,23266,12054,1352,3814,27148,"Virginia Beach city, Virginia",51,810,51810
15023.0,287.0,185.0,0.0,35,5782,6600,2532,1362,1347,15,4068,3146,2886,260,6600,47673,0.4595,38.9,8027,14861,13772,70,58,19,36,906,"Alleghany County, Virginia",51,005,51005
6412.0,394.0,129.0,17.0,15,2587,2663,965,476,476,0,1698,1253,1220,33,2663,33575,0.5191,37.6,3327,6273,5135,105,14,11,296,712,"Galax city, Virginia",51,640,51640
17469.0,980.0,450.0,5.0,30,7641,7923,3168,1904,1660,244,4755,3473,3097,376,7923,53853,0.4791,40.0,10951,17537,15166,126,182,86,287,1690,"Westmoreland County, Virginia",51,193,51193
12125.0,754.0,111.0,31.0,8,4673,5584,3204,2094,1942,152,2380,1911,1769,142,5584,62632,0.4507,39.0,9277,12190,10895,59,102,0,0,1134,"Northumberland County, Virginia",51,133,51133
33917.0,1660.0,578.0,27.0,44,15291,14533,5251,3441,3351,90,9282,6853,6138,715,14533,53866,0.4271,39.3,17304,33022,30165,367,170,16,96,2208,"Pulaski County, Virginia",51,155,51155
38935.0,2205.0,443.0,89.0,32,19065,14651,4432,2948,2810,138,10219,7890,7215,675,14651,69116,0.3967,39.0,16387,39180,33822,760,478,95,401,3624,"Warren County, Virginia",51,187,51187
40615.0,1389.0,905.0,99.0,437,16068,18293,6253,3373,3203,170,12040,8125,7199,926,18293,37203,0.4832,38.0,22072,39900,35182,535,332,34,525,3292,"Danville city, Virginia",51,590,51590
28140.0,4305.0,1134.0,309.0,852,15653,10762,2336,1223,1133,90,8426,5547,4493,1054,10762,65641,0.4579,37.4,11725,28442,23709,720,898,158,1121,1836,"Fredericksburg city, Virginia",51,630,51630
31522.0,2095.0,562.0,139.0,40,14361,12160,4577,2824,2695,129,7583,6029,5606,423,12160,52888,0.4197,38.4,14190,31589,28205,288,146,10,117,2823,"Amherst County, Virginia",51,009,51009
4262.0,167.0,147.0,0.0,28,1925,1801,631,365,333,32,1170,945,767,178,1801,49738,0.3879,39.3,3379,4231,3675,11,53,0,27,465,"Bath County, Virginia",51,017,51017
22248.0,1750.0,944.0,8.0,38,9326,9224,2647,1527,1373,154,6577,4911,4394,517,9224,39030,0.4642,39.2,10323,22156,19504,364,213,112,129,1834,"Hopewell city, Virginia",51,670,51670
176852.0,9392.0,8117.0,1289.0,3012,87850,69835,16758,9932,9350,582,53077,36930,32853,4077,69835,53215,0.4438,39.3,77759,169839,141448,5799,3557,792,2894,15349,"Newport News city, Virginia",51,700,51700
85350.0,4924.0,1465.0,452.0,87,42475,31503,10099,6936,6763,173,21404,18105,16839,1266,31503,78002,0.3905,39.3,34161,85121,74493,1648,1745,397,1558,5280,"Frederick County, Virginia",51,069,51069
79374.0,5076.0,4149.0,612.0,985,35712,28273,7986,4537,4256,281,20287,14702,11945,2757,28273,46409,0.4623,35.1,32410,78994,68564,1203,2021,282,704,6220,"Lynchburg city, Virginia",51,680,51680
67264.0,4207.0,3150.0,1097.0,88,33558,25103,7437,4884,4694,190,17666,15185,14228,957,25103,92069,0.389,39.3,27896,64131,56773,3092,1507,75,528,2156,"York County, Virginia",51,199,51199
12579.0,1178.0,267.0,15.0,109,5074,5532,1757,1091,1045,46,3775,2460,2230,230,5532,34371,0.5028,39.3,7067,12429,10636,192,215,0,67,1319,"Martinsville city, Virginia",51,690,51690
14675.0,553.0,115.0,30.0,0,6769,6419,2682,1968,1911,57,3737,2891,2610,281,6419,64313,0.4654,39.0,10175,14785,13064,166,209,0,59,1287,"Nelson County, Virginia",51,125,51125
60716.0,997.0,996.0,24.0,38,27190,26267,9807,6403,6249,154,16460,13026,12221,805,26267,47690,0.4442,39.0,31650,60021,54226,330,306,71,344,4744,"Pittsylvania County, Virginia",51,143,51143
6369.0,432.0,577.0,10.0,0,2818,2517,888,605,594,11,1629,1267,1157,110,2517,32455,0.4944,36.3,2866,6394,5624,24,44,0,0,702,"Buena Vista city, Virginia",51,530,51530
13967.0,1047.0,553.0,525.0,1369,7813,5493,1245,721,685,36,4248,3192,2921,271,5493,127610,0.4556,39.3,6004,14060,11190,1611,884,17,201,157,"Falls Church city, Virginia",51,610,51610
30990.0,3013.0,940.0,231.0,309,13180,13165,3906,2135,1982,153,9259,5440,4662,778,13165,38679,0.4896,38.1,16367,30438,25846,419,411,38,324,3400,"Petersburg city, Virginia",51,730,51730
12008.0,786.0,322.0,94.0,0,5965,4593,1537,1105,1095,10,3056,2535,2386,149,4593,97118,0.3912,38.9,4801,11782,10926,377,122,0,18,339,"Poquoson city, Virginia",51,735,51735
23212.0,2220.0,495.0,548.0,996,12380,8577,2214,1676,1607,69,6363,5144,4309,835,8577,116979,0.4053,38.6,8959,22994,15706,3340,2186,239,936,587,"Fairfax city, Virginia",51,600,51600
21898.0,1929.0,269.0,170.0,108,10256,9193,2886,1297,1199,98,6307,4393,3865,528,9193,45011,0.4641,38.7,10023,21960,18453,142,380,61,250,2674,"Waynesboro city, Virginia",51,820,51820
97959.0,5979.0,2406.0,437.0,1686,46945,41740,11609,6483,6011,472,30131,19298,16484,2814,41740,44230,0.4802,38.5,47010,98035,82459,2028,2932,49,1643,8924,"Roanoke city, Virginia",51,770,51770
88716.0,4895.0,2573.0,631.0,162,43526,33774,9246,6146,5960,186,24528,20022,18772,1250,33774,74884,0.4341,39.7,36769,87819,79611,1744,906,31,415,5112,"Suffolk city, Virginia",51,800,51800
241077.0,17760.0,18419.0,1991.0,4622,129511,88353,19880,11198,10560,638,68473,47103,39927,7176,88353,51590,0.491,40.7,97670,215745,177936,7208,4932,686,3356,21627,"Norfolk city, Virginia",51,710,51710
12846.0,628.0,21.0,8.0,69,6267,4954,1783,1161,1086,75,3171,2551,2368,183,4954,57946,0.4392,38.6,5591,12861,11439,91,0,0,58,1273,"Amelia County, Virginia",51,007,51007
339207.0,14199.0,7931.0,1566.0,693,173790,124971,35254,23516,22616,900,89717,73883,68566,5317,124971,82599,0.4076,39.0,130707,340982,293729,13864,7421,1328,6961,17679,"Chesterfield County, Virginia",51,041,51041
1132495.0,31778.0,40564.0,18331.0,59130,613920,396501,103131,72437,69327,3110,293370,234889,213988,20901,396501,124831,0.4258,39.2,413885,1131851,746265,184288,108200,14565,50482,28051,"Fairfax County, Virginia",51,059,51059
41379.0,1513.0,1039.0,176.0,128,16789,17675,6520,4081,3889,192,11155,8776,7989,787,17675,47240,0.4317,37.3,23208,41341,34385,787,1465,72,2032,2600,"Okanogan County, Washington",53,047,53047
45477.0,5748.0,1222.0,317.0,340,21851,18347,5218,3065,2931,134,13129,9661,6998,2663,18347,56004,0.4535,35.8,23801,45547,40567,1072,1101,33,141,2633,"Kittitas County, Washington",53,037,53037
102371.0,3355.0,2413.0,66.0,53,50594,39770,12052,7740,7454,286,27718,23202,21819,1383,39770,69433,0.3964,39.4,41833,102805,93507,1058,781,39,202,7218,"Cass County, Missouri",29,037,29037
20282.0,1012.0,508.0,59.0,96,9577,8177,2313,1433,1306,127,5864,4786,4396,390,8177,62701,0.3673,39.5,9001,20044,18322,188,94,10,0,1430,"Clinton County, Missouri",29,049,29049
16440.0,684.0,40.0,0.0,15,6197,6209,2300,1508,1431,77,3909,3058,2757,301,6209,43542,0.4724,40.4,7683,16382,13557,102,159,0,0,2564,"Dallas County, Missouri",29,059,29059
9365.0,580.0,120.0,12.0,0,3093,3976,2116,1215,1147,68,1860,1273,1213,60,3976,34182,0.4235,41.0,6869,9326,7833,45,0,22,0,1426,"Hickory County, Missouri",29,085,29085
55908.0,2539.0,643.0,65.0,110,26359,19286,5137,3258,3162,96,14149,11993,11292,701,19286,64196,0.4017,38.9,21681,55897,50906,441,182,43,13,4312,"Lincoln County, Missouri",29,113,29113
8525.0,224.0,76.0,0.0,0,3794,3702,1308,784,754,30,2394,1824,1657,167,3702,43966,0.4071,39.4,4862,8522,7671,17,24,0,7,803,"Monroe County, Missouri",29,137,29137
57465.0,2764.0,1427.0,67.0,58,26262,22202,6922,4382,4175,207,15280,12249,11352,897,22202,50813,0.4716,39.5,24753,57544,49055,713,502,116,554,6604,"Newton County, Missouri",29,145,29145
18199.0,1274.0,287.0,48.0,10,7303,6589,2149,1273,1208,65,4440,3342,2990,352,6589,46385,0.4326,39.7,7913,16245,14705,36,24,0,4,1476,"Pike County, Missouri",29,163,29163
390036.0,12766.0,6203.0,764.0,350,208950,146631,40469,25880,25051,829,106162,86738,80081,6657,146631,84978,0.3962,38.6,154273,392268,361252,7164,6150,575,2052,15075,"St. Charles County, Missouri",29,183,29183
77453.0,4568.0,1913.0,422.0,138,36972,29594,8369,5061,4827,234,21225,16646,14052,2594,29594,53732,0.4609,37.9,33950,77243,69257,536,1320,22,321,5787,"Cape Girardeau County, Missouri",29,031,29031
54857.0,2152.0,1491.0,310.0,6,24362,21646,6845,4119,3950,169,14801,11707,10827,880,21646,50351,0.4436,40.1,24070,54520,48645,389,478,0,690,4318,"Coffee County, Tennessee",47,031,47031
39839.0,1229.0,920.0,106.0,10,17358,15596,5578,4035,3934,101,10018,8054,7633,421,15596,60711,0.478,40.4,17114,39584,36369,245,177,111,181,2501,"Fayette County, Tennessee",47,047,47047
6487.0,247.0,25.0,0.0,26,2158,2742,999,600,600,0,1743,1204,1129,75,2742,30136,0.5593,38.6,3621,6417,5688,39,0,0,27,663,"Hancock County, Tennessee",47,067,47067
55940.0,2359.0,566.0,8.0,79,21740,23135,8112,5136,4988,148,15023,11491,10929,562,23135,41924,0.4672,38.6,27290,55941,50393,233,314,0,23,4978,"Hawkins County, Tennessee",47,073,47073
17621.0,748.0,471.0,11.0,56,5606,6794,2885,1868,1819,49,3909,3059,2816,243,6794,36004,0.5183,38.4,9002,15777,13787,41,162,8,118,1661,"Johnson County, Tennessee",47,091,47091
33695.0,957.0,940.0,61.0,48,14793,13548,4564,2809,2703,106,8984,6983,6561,422,13548,49485,0.4415,39.5,15545,33573,30391,150,204,7,319,2502,"Lincoln County, Tennessee",47,103,47103
23578.0,861.0,373.0,14.0,0,10347,9170,2642,1533,1513,20,6528,5145,4702,443,9170,37430,0.4589,40.2,10339,23460,20709,84,91,24,382,2170,"Macon County, Tennessee",47,111,47111
6348.0,404.0,86.0,9.0,0,2766,2592,838,623,578,45,1754,1376,1284,92,2592,57708,0.4439,39.9,3050,6282,5575,16,93,0,0,598,"Moore County, Tennessee",47,127,47127
69556.0,3493.0,1036.0,257.0,126,33493,25713,7112,4950,4717,233,18601,16036,15323,713,25713,63307,0.424,40.2,27315,69307,62016,585,748,68,1318,4572,"Robertson County, Tennessee",47,147,47147
41286.0,1317.0,884.0,97.0,18,18039,16326,5519,3716,3551,165,10807,8120,7646,474,16326,51585,0.4796,38.9,19351,41376,36946,335,514,170,222,3189,"Franklin County, Tennessee",47,051,47051
128887.0,2691.0,2294.0,257.0,68,60295,50557,17688,11759,11285,474,32869,25578,23520,2058,50557,56667,0.452,39.1,57709,128660,115055,1356,1062,73,1241,9873,"Blount County, Tennessee",47,009,47009
39793.0,2281.0,501.0,204.0,42,19750,15089,4183,2921,2787,134,10906,9039,8235,804,15089,61913,0.383,39.6,16263,39814,35453,382,229,93,390,3267,"Cheatham County, Tennessee",47,021,47021
56222.0,2018.0,1274.0,59.0,19,22688,23784,8347,5098,5023,75,15437,11275,10233,1042,23784,38092,0.4719,39.2,28173,55390,48181,263,256,26,261,6403,"Carter County, Tennessee",47,019,47019
22920.0,1058.0,592.0,50.0,42,9464,8959,3190,2148,2044,104,5769,4683,4466,217,8959,44064,0.4515,38.7,11127,22958,20467,133,75,0,381,1902,"Grainger County, Tennessee",47,057,47057
28918.0,992.0,691.0,184.0,0,12406,11904,4014,2510,2328,182,7890,6116,5479,637,11904,49614,0.4346,40.4,14095,28857,25623,159,392,27,33,2623,"Giles County, Tennessee",47,055,47055
25646.0,1548.0,247.0,42.0,34,8906,9675,2973,1928,1855,73,6702,5210,4898,312,9675,39896,0.43,40.0,11317,23153,20674,160,51,60,135,2073,"Lauderdale County, Tennessee",47,097,47097
42775.0,898.0,591.0,37.0,16,16399,15960,5475,3136,3043,93,10485,8565,7985,580,15960,43614,0.443,39.7,18260,42913,37147,160,121,64,126,5295,"Lawrence County, Tennessee",47,099,47099
96381.0,2951.0,1319.0,222.0,239,43358,37944,11098,6752,6577,175,26846,20033,18542,1491,37944,48161,0.4717,38.8,43124,96293,85799,1230,375,147,1207,7535,"Madison County, Tennessee",47,113,47113
28314.0,443.0,325.0,21.0,9,12250,11477,3857,2596,2524,72,7620,5912,5590,322,11477,49432,0.4418,39.4,13370,28247,25766,78,107,26,58,2212,"Marion County, Tennessee",47,115,47115
21777.0,533.0,109.0,30.0,9,9192,9140,3209,1905,1875,30,5931,4567,4345,222,9140,37197,0.455,38.6,10366,21775,19643,196,69,0,35,1832,"Overton County, Tennessee",47,133,47133
5060.0,409.0,138.0,0.0,0,1814,2281,999,627,606,21,1282,1003,994,9,2281,39554,0.4628,38.7,3508,4999,4785,14,0,0,9,191,"Pickett County, Tennessee",47,137,47137
16573.0,529.0,314.0,22.0,0,5646,5764,2184,1252,1204,48,3580,2937,2812,125,5764,41427,0.4529,39.3,7349,14612,12764,74,27,49,7,1691,"Wayne County, Tennessee",47,181,47181
223158.0,10460.0,10857.0,1272.0,362,112345,77855,19146,14320,13767,553,58709,51331,48961,2370,77855,112962,0.4434,39.0,81772,224921,200182,7765,6745,524,2112,7593,"Williamson County, Tennessee",47,187,47187
47606.0,1140.0,519.0,146.0,35,21611,17029,5017,3387,3247,140,12012,10220,9457,763,17029,50415,0.4434,41.0,19133,47915,41081,603,840,49,1374,3968,"Bedford County, Tennessee",47,003,47003
68115.0,1479.0,1635.0,177.0,9,27695,27396,9740,6189,5989,200,17656,13225,12321,904,27396,42595,0.4777,39.0,32534,67539,60485,334,350,20,266,6084,"Greene County, Tennessee",47,059,47059
58826.0,1717.0,1910.0,63.0,0,21291,25801,11910,8271,7866,405,13891,10600,9826,774,25801,45958,0.4276,39.5,29714,58597,52102,576,289,17,153,5460,"Cumberland County, Tennessee",47,035,47035
5715.0,370.0,52.0,12.0,9,2079,2141,856,573,543,30,1285,1068,1002,66,2141,42724,0.4072,39.4,2692,5653,4744,31,41,0,0,837,"Van Buren County, Tennessee",47,175,47175
31333.0,655.0,1319.0,118.0,26,11753,13281,4333,2746,2627,119,8948,6503,6056,447,13281,36835,0.4798,40.3,15421,31098,28534,62,139,55,129,2179,"Claiborne County, Tennessee",47,025,47025
24506.0,563.0,142.0,14.0,14,9791,8636,2962,1828,1758,70,5674,4159,3853,306,8636,43596,0.4718,39.9,10496,23094,20937,119,64,0,40,1934,"Hickman County, Tennessee",47,081,47081
18302.0,742.0,215.0,4.0,0,7335,6763,2411,1448,1441,7,4352,3182,2934,248,6763,45667,0.447,39.2,8955,18211,16741,36,32,79,75,1248,"Humphreys County, Tennessee",47,085,47085
76450.0,4480.0,1657.0,250.0,2,34074,31424,9121,5560,5401,159,22303,16719,14274,2445,31424,44259,0.4779,38.5,34336,76513,67745,938,1465,177,978,5210,"Putnam County, Tennessee",47,141,47141
96228.0,2550.0,3413.0,535.0,196,45553,37210,12527,8782,8356,426,24683,19812,17820,1992,37210,49610,0.4242,38.6,57424,96046,79195,1043,1151,179,2555,11923,"Sevier County, Tennessee",47,155,47155
13211.0,736.0,492.0,12.0,14,5253,5178,1898,1146,1085,61,3280,2350,2270,80,5178,45809,0.403,40.6,6863,13223,11966,126,91,29,54,957,"Stewart County, Tennessee",47,161,47161
17048.0,470.0,481.0,8.0,6,6922,6060,2077,1339,1250,89,3983,3415,3221,194,6060,51946,0.4147,39.8,7125,16930,14413,88,128,0,71,2230,"Chester County, Tennessee",47,023,47023
11551.0,309.0,70.0,23.0,28,4338,4440,1761,1119,1108,11,2679,2053,1951,102,4440,42031,0.4923,40.4,6910,11444,10340,42,22,0,0,1040,"Decatur County, Tennessee",47,039,47039
11615.0,433.0,202.0,52.0,5,4254,4566,1868,987,910,77,2698,1968,1835,133,4566,35207,0.466,37.7,5907,11469,10139,20,24,30,50,1206,"Jackson County, Tennessee",47,087,47087
25598.0,480.0,456.0,26.0,7,9315,10022,3754,2284,2251,33,6268,4749,4473,276,10022,39161,0.4404,40.1,12060,25506,22602,98,55,44,45,2662,"McNairy County, Tennessee",47,109,47109
52710.0,2038.0,2088.0,99.0,5,21581,20901,7985,4835,4709,126,12916,9973,9239,734,20901,53367,0.4799,38.6,25657,52392,47426,609,268,50,105,3934,"Roane County, Tennessee",47,145,47145
104444.0,2773.0,2702.0,243.0,92,48153,40192,12204,8078,7714,364,27988,21511,19602,1909,40192,51331,0.4539,38.6,43736,104628,89343,1777,1892,371,2142,9103,"Bradley County, Tennessee",47,011,47011
63446.0,2143.0,792.0,180.0,38,26120,24456,8184,5027,4855,172,16272,12652,11536,1116,24456,43619,0.454,38.9,27169,63301,54726,643,897,90,2219,4726,"Hamblen County, Tennessee",47,063,47063
19375.0,908.0,339.0,22.0,7,7259,7405,2407,1626,1586,40,4998,4104,3885,219,7405,44671,0.47,39.2,9381,19304,17001,61,122,0,14,2106,"Union County, Tennessee",47,173,47173
25430.0,381.0,353.0,8.0,16,9644,10137,3689,2336,2267,69,6448,5170,4936,234,10137,40682,0.4817,39.8,14079,25278,22331,53,11,134,198,2551,"Hardin County, Tennessee",47,071,47071
51935.0,2241.0,1066.0,54.0,22,23271,19198,5667,3565,3286,279,13531,10632,9744,888,19198,53076,0.4424,39.5,21813,52292,45912,358,294,43,369,5316,"Dickson County, Tennessee",47,043,47043
21371.0,1530.0,259.0,23.0,2,7178,7625,2688,1709,1658,51,4937,4221,4001,220,7625,41333,0.4534,38.5,9041,18692,16721,36,32,38,5,1860,"Morgan County, Tennessee",47,129,47129
45535.0,1339.0,1556.0,111.0,64,17396,17987,6386,4298,4185,113,11601,9093,8662,431,17987,42429,0.4371,40.1,21235,45514,40488,583,245,99,165,3934,"Monroe County, Tennessee",47,123,47123
31950.0,669.0,904.0,11.0,18,12336,13394,5297,3208,3043,165,8097,6526,5981,545,13394,40502,0.4678,38.5,17236,31794,28705,189,67,15,63,2755,"Henry County, Tennessee",47,079,47079
14252.0,648.0,89.0,6.0,0,5984,5491,1788,1100,1050,50,3703,2897,2650,247,5491,44717,0.4459,39.9,6414,14184,12364,170,75,44,336,1195,"Crockett County, Tennessee",47,033,47033
7350.0,1077.0,96.0,0.0,0,1769,2243,746,503,484,19,1497,1133,1014,119,2243,35191,0.5416,41.4,2607,4603,4048,25,9,0,0,521,"Lake County, Tennessee",47,095,47095
456684.0,16326.0,14865.0,1814.0,1778,228585,187319,51283,30757,29307,1450,136036,99865,86728,13137,187319,57470,0.4808,38.5,205620,457097,404708,8791,7821,1049,5043,29685,"Knox County, Tennessee",47,093,47093
195149.0,6429.0,4912.0,619.0,661,87101,72121,20040,12478,11773,705,52081,41407,37621,3786,72121,69023,0.4246,38.5,76241,196146,166469,7518,7911,627,5032,8589,"Benton County, Washington",53,005,53005
467963.0,6666.0,21549.0,2273.0,4621,222844,174661,49829,32452,30776,1676,124832,102458,91149,11309,174661,75253,0.4237,38.4,182742,470426,402647,26490,14075,1732,7548,17934,"Clark County, Washington",53,011,53011
